पचड़ा	_onto_nodes	भुँइफोर
निमि	_onto_nodes	चालचलन
ग्रॉस्ज़ी	_onto_nodes	भुँइफोर
जिम्बाबवेइयाई	_hypernym	रेहुआ
पुष्करसद	_hypernym	गोचरपिण्ड
शवाधार	_onto_nodes	रङ्गमहल
बैल-हाट	_onto_nodes	सूपाबेना
उष्णता	_onto_nodes	अवाकी
फक	_onto_nodes	सत्यसन्ध
अभिलाषक	_onto_nodes	बिलल्ला
अडोल	_onto_nodes	भुँइफोर
रामावत	_hypernym	समाँ_बाँधना
तराज़ू_डंड	_onto_nodes	रङ्गमहल
अनद्यतनभविष्य	_hypernym	लुआंडा
इंजीनियरी	_onto_nodes	साया
कर्णकटु	_hypernym	उनतालीस
अंबु_तस्कर	_onto_nodes	प्रतिधावन
बड़बड़ाना	_hypernym	नकल_उतारना
कामोदतिलक	_hypernym	नरपति
नाइल	_onto_nodes	अनिष्टकर
वॉट	_onto_nodes	खपाची
जलोद्धतिगति	_onto_nodes	पैरदान
जड़मति	_hypernym	अन्तर्वेश्म
चन्डेल	_hypernym	अम्बाला_ज़िला
नौग्रही	_onto_nodes	पैरदान
गर्भ_झिल्ली	_hypernym	वराम्ल
ख़लिस	_onto_nodes	अवाकी
श्रुतदेवी	_hypernym	कुवारी
ठनकना	_onto_nodes	सृंजय
कांजीवरम्_जिला	_onto_nodes	भुँइफोर
जलाना	_onto_nodes	अवात
विषुव_वर्ष	_onto_nodes	एकलक
रक्तफला	_hypernym	गोचरपिण्ड
अभयदक्षिणा	_onto_nodes	भुँइफोर
केवटाई	_hypernym	धाव_पट्टी
अप्रतिमान	_onto_nodes	ईयर
करपात्र	_hypernym	टेलिफून
निन्दा	_hypernym	ओं
अभिशंसा	_onto_nodes	अवाकी
पिकबन्धुर	_hypernym	सुघड़
पेट्रोल_पंप	_onto_nodes	सूपाबेना
अलांग	_onto_nodes	अनिष्टकर
अवाह्य	_hypernym	श्वेतकांडा
व्हेल	_hypernym	प्रूफ़रीडर
नवादा_शहर	_onto_nodes	रङ्गमहल
श्रेणी	_hypernym	पैराकी
नैशनलिस्ट_कांग्रेस_पार्टी	_onto_nodes	नवधा-भक्ति
शंकाहीन	_onto_nodes	निकुरम्ब
टघराना	_hypernym	ऐल्प्स_पर्वत
ढहा_हुआ	_onto_nodes	सृंजय
अहीश	_hypernym	अभिरना
बेरहमी	_hypernym	मरीना
पहाड़ी_बुलबुल	_onto_nodes	अनिष्टकर
पंचायत	_onto_nodes	खपाची
श्वेत-पुष्पा	_onto_nodes	सूपाबेना
भीमरा	_hypernym	गोचरपिण्ड
सुघराई-कान्हड़ा	_onto_nodes	सृंजय
भद्रदेह	_onto_nodes	ज्येष्ठत्व
अपहरण_करना	_onto_nodes	मेक्सिको
सौंदर्य_मीमांसा	_onto_nodes	मोतियदाम
चौर	_hypernym	रुवाबदार
दीवाला_निकलना	_onto_nodes	भुँइफोर
पेटी	_onto_nodes	पिछलगा
क़ैदी	_hypernym	दनायुषा
वार्मअप_मैच	_hypernym	सिंधुजा
जला	_onto_nodes	रखैया
विधि_विशेषज्ञ	_onto_nodes	भुँइफोर
गुड़गाँव_शहर	_hypernym	डुलाना
कचोरा	_hypernym	मसलन
अजूजा	_hypernym	झांकी
स्पेशलिस्ट	_hypernym	निशामुख
संसद-सदस्य	_onto_nodes	अधिदिवस
परिपोषण	_onto_nodes	अवाकी
भलमनसाहट	_onto_nodes	सत्यसन्ध
राष्ट्रीय_सुरक्षा_परिषद	_onto_nodes	भुँइफोर
सरजूपारी	_hypernym	तुटुम
अवटुग्रंथि	_hypernym	नेपीडॉ
युद्ध_विराम_ध्वजा	_onto_nodes	प्रतिधावन
सूझना	_hypernym	विभु
शालरस	_onto_nodes	बहवाना
सन्यासी	_onto_nodes	मेक्सिको
खुनस	_onto_nodes	व्यास
दक्षिणी_त्रिपुरा_जिला	_onto_nodes	रङ्गमहल
द्वंद्वयुद्ध	_onto_nodes	चंद्राकार
अलोभ	_onto_nodes	साया
बंगलूरी	_onto_nodes	भुँइफोर
महाजवा	_hypernym	धाव_पट्टी
बसन्त	_onto_nodes	रङ्गमहल
आत्यंतिक	_onto_nodes	अवाकी
कामदार	_hypernym	मसलन
निपट_गँवार	_onto_nodes	भुँइफोर
कुचियादाँत	_onto_nodes	भुँइफोर
मटियाला	_hypernym	अंतावसायी
हिलता	_onto_nodes	प्रतिधावन
अभिरम्य	_hypernym	युद्धपोत
घनगर्जन	_hypernym	मत्तेवविक्रीड़ित
वरुणदैव	_onto_nodes	बहवाना
साफ़_करना	_onto_nodes	साया
एलुरु_शहर	_hypernym	पिष्ट-पेषण
कामुकतापूर्ण	_onto_nodes	व्यास
माई	_hypernym	पत्तर
उपनयन_संस्कार	_onto_nodes	संगीतात्मक
दुनियाँ	_hypernym	श्रवनीय
कीर्तिवन्त	_onto_nodes	साया
रेल_टिकिट	_onto_nodes	आचार्य्यी
झुग्गीवासी	_onto_nodes	सीकर
तुरंगगौड़	_onto_nodes	सृंजय
तिरासी	_onto_nodes	भुँइफोर
मुकद्दमेबाज	_onto_nodes	भुँइफोर
नवकार्षिगूगल	_onto_nodes	रङ्गमहल
नक्शानवीस	_hypernym	पब्लिक_प्रॉसिक्यूटर
सनसनाहट	_onto_nodes	बहवाना
असकल	_onto_nodes	सृंजय
अधिमंथ_रोग	_hypernym	अवतरण_करना
ढाई	_onto_nodes	सृंजय
चाकलेट	_hypernym	धाव_पट्टी
अभिरमणीय	_hypernym	स्टेट_बैंक_आफ_हैदराबाद
साफ_होना	_onto_nodes	खपाची
अमीत	_hypernym	जैन_धर्म
शरभ_उपनिषद्	_onto_nodes	बहवाना
नख	_hypernym	परलोक_सिधारना
कत	_hypernym	रग्बी
स्वैच्छिक	_onto_nodes	खपाची
नभस्थल	_hypernym	टेलिफून
अलम्बुषा	_hypernym	कोरी
तोयपर्णी	_onto_nodes	तुरंगिका
ताल-मेल	_onto_nodes	बहवाना
खेती_बारी	_hypernym	झांकी
ख्मेर_भाषा	_hypernym	डायल
भुजंगम	_hypernym	अभिरना
ढफ	_onto_nodes	पिछलगा
बहरा_होना	_onto_nodes	साया
कुर्क_करना	_hypernym	जुंबली_भेड़
सेवती	_hypernym	सामुद्रिकी
इतमीनान	_onto_nodes	अमानुष
रत्नकण	_hypernym	जलन्धर
तुकहीन	_onto_nodes	अवाकी
कृत्रिम_उपग्रह	_hypernym	कोरी
हड़गीला	_onto_nodes	प्रतिधावन
उतरंग	_onto_nodes	रोकनेवाला
अनेग	_onto_nodes	बांदीपुरा
दुआँ	_onto_nodes	सत्यसन्ध
नामाङ्कित	_onto_nodes	भुँइफोर
अर्धमृत	_onto_nodes	भुँइफोर
पर्हेजगार	_onto_nodes	भुँइफोर
फ़िक्र	_hypernym	स्मृति_चिह्न
आईफोन	_hypernym	सहलाई
क्यंशी_नदी	_onto_nodes	पाणिनीय
अमितवीर्य	_onto_nodes	ज्येष्ठत्व
कमोडिटी	_onto_nodes	भुँइफोर
उजरत	_onto_nodes	चालचलन
मौद्रिक	_onto_nodes	सृंजय
डोंड़ी	_onto_nodes	व्यास
मन्थनी	_onto_nodes	भुँइफोर
उदयपुर	_hypernym	रेहुआ
लालक	_hypernym	रिकांग_पियो_शहर
गण्डगोपालिका	_hypernym	रेहुआ
उत्तरीअमरीका_वासी	_hypernym	निरालंब
दुर्ग्राहिता	_hypernym	सिंधुजा
मुश्कबू	_hypernym	प्रसिति
तार-घर	_onto_nodes	अनतुला
जाले_बुनना	_hypernym	पब्लिक_प्रॉसिक्यूटर
अर्द्धगङ्गा	_hypernym	अभिरना
चित्तग्राही	_hypernym	लाल_साग
जुर्म	_onto_nodes	भुँइफोर
मुर्शिदाबाद_जिला	_onto_nodes	भुँइफोर
पञ्चनाम	_onto_nodes	सूपाबेना
औसतन	_onto_nodes	बहवाना
अनुवाक्	_onto_nodes	ग्रोस
सुस्ताना	_onto_nodes	गड़गड़ा
इकासीवाँ	_onto_nodes	प्रमत्तता
जम्बु_द्वीप	_onto_nodes	बाणगङ्गा_नदी
अपराधभंजन	_hypernym	टेलिफून
पानकपूर	_onto_nodes	सृंजय
अंडरना	_onto_nodes	तुरंगिका
विवसन	_onto_nodes	सृंजय
फ़सली	_onto_nodes	रङ्गमहल
उल्लासित	_onto_nodes	ईयर
तिलचटा	_onto_nodes	ज्येष्ठत्व
अमरपति	_onto_nodes	खपाची
गौणता	_hypernym	दीर्घलोचन
अवतारना	_hypernym	वराम्ल
तुर्कमेनिस्तानी_मनट	_hypernym	आंत्रीय_ज्वर
पसही	_hypernym	उसी_तरह
पाथोनिधि	_onto_nodes	सृंजय
मूड़ीबँध	_hypernym	चूत
पावका	_onto_nodes	ईयर
जमुना_नदी	_onto_nodes	ईयर
मिनिस्टर	_onto_nodes	साया
अजेय	_hypernym	नरपति
कोलीपाड़ा	_onto_nodes	खपाची
हरखना	_hypernym	कल्याणकारी_कार्यक्रम
अवमूल्यन	_hypernym	कोरी
असांसद	_onto_nodes	अपमान_कर्त्ता
तनय	_hypernym	बिलल्ला
झुट-पुटा	_onto_nodes	सीकर
बँधाई	_hypernym	गोचरपिण्ड
आनुवंशिकता	_hypernym	नरपति
बाधी	_onto_nodes	बहवाना
बायोइन्जीनीयरिंग	_hypernym	दिगेश
एआईएफएफ	_hypernym	धाव_पट्टी
सिप्रा_नदी	_onto_nodes	संगीतात्मक
आंबेडकर	_hypernym	गोचरपिण्ड
वायु_दाब	_onto_nodes	ईयर
नटरंग	_hypernym	बिलल्ला
द्रूज	_hypernym	अंतःकोष
कमजोर	_hypernym	जन्मपत्री
फिकर_करना	_onto_nodes	ईयर
घूमना-फिरना	_hypernym	अजकब
मुखालु	_onto_nodes	खपाची
प्लक्षा	_onto_nodes	अमानुष
जन्म-काल	_hypernym	उक्ति
जम्बूप्रस्थ	_hypernym	पर्णकार
कण्ठ_रोहिणी	_onto_nodes	भुँइफोर
कमल_गट्टा	_onto_nodes	साया
विश्वधारा_दिन	_onto_nodes	भुँइफोर
तँबोलिन	_hypernym	सीमोल्लंघन
मुलाज़िम	_onto_nodes	नवधा-भक्ति
शयाण्डक	_onto_nodes	छलशून्यता
पदातिक_सेना	_hypernym	सह_संक्रमण
एक्स्ट्रा	_hypernym	होम_मिनिस्टर
तुर्श-मिज़ाज	_onto_nodes	नन्दा
चापट	_onto_nodes	अनतुला
अप्रजा	_hypernym	उछकना
विसर्ग	_onto_nodes	साया
ख़ामोशी_से	_onto_nodes	अमानुष
पाकशाला	_onto_nodes	अनतुला
तरजुमा_करना	_onto_nodes	खपाची
जोखिमभरा	_onto_nodes	खपाची
उँडलवाना	_hypernym	अबीरा
तैत्तिरीय	_onto_nodes	खपाची
इकीस	_onto_nodes	सत्यसन्ध
अपृक्त	_hypernym	वारीन्द्र
नभोमणि	_onto_nodes	चंद्राकार
दुरदुराना	_hypernym	कुवैतवासी
परदादी	_onto_nodes	अपमान_कर्त्ता
अनन्यता	_hypernym	ब्रोकर_एकाउंट
दौर्गंधि	_hypernym	द्रोणकाक
तमिल_लिपि	_onto_nodes	मेक्सिको
सुअरी	_onto_nodes	भुँइफोर
जाना_माना	_onto_nodes	सत्यसन्ध
उच्छेतव्य	_hypernym	चूत
पंचवायु	_onto_nodes	बहवाना
भसींड	_onto_nodes	भुँइफोर
बकसुवा	_hypernym	कुवारी
दाढ़ी	_onto_nodes	सृंजय
इंद्रिय-बोध	_onto_nodes	चोरबदन
सहनशील	_onto_nodes	तुरंगिका
खपाची	_onto_nodes	अवाकी
सर्प-दंश	_hypernym	मिसराता
बया_का_घोंसला	_onto_nodes	ज्येष्ठत्व
सीतापुर	_onto_nodes	बहवाना
डापोरिजो	_hypernym	निरालंब
_पेटार्थू	_onto_nodes	नवधा-भक्ति
अर्जेन्टाइन	_onto_nodes	साया
छेदनीय	_onto_nodes	भुँइफोर
कूहू_नदी	_hypernym	बिलल्ला
महालोभ	_hypernym	निःशुल्क
मौरिटानियावासी	_hypernym	_हिस्पैनिक_अमेरिकन
नैपाल_वासी	_onto_nodes	खपाची
मैनटी	_onto_nodes	साया
नव-खंड	_onto_nodes	रोफी
नृशंस	_hypernym	सीरियन_पाउंड
संसृष्ट	_hypernym	करारना
अलक्षणी	_hypernym	थ्योरी
अविकृति	_onto_nodes	बिलल्ला
याज्ञवल्क्य_उपनिषद्	_onto_nodes	खपाची
उत्तरी_कोरिया	_hypernym	बिलल्ला
बुंदेला_वंश	_onto_nodes	भुँइफोर
हिस्सेदारी	_onto_nodes	सीकर
विपुला	_onto_nodes	सृंजय
रेडियो_फ्रीक्वेंसी	_hypernym	समागम
अर्द्धाङ्गिनी	_onto_nodes	सीकर
वटपूर्णिमा	_hypernym	वीर्यरहित
बैलेंस्ड	_onto_nodes	खपाची
निर्वहण_करना	_onto_nodes	खपाची
बाकायदा	_hypernym	आराति
कुदृष्टि	_onto_nodes	वराहक्रान्ता
मढ़ाई	_onto_nodes	साया
धर्मी	_hypernym	टेलिफून
आइसलैंडिक	_onto_nodes	मोतियदाम
सय	_hypernym	भू-वायु
अमर-राज	_onto_nodes	ईयर
प्रमत्तता	_onto_nodes	छलशून्यता
श्वेतधामा	_hypernym	क्षीणक-रोग
सिन्धुलवण	_onto_nodes	चालचलन
मण्डूर_भस्म	_hypernym	ध्रुवीय
रोग-प्रतिकारक	_hypernym	५७
जीवंती	_onto_nodes	भुँइफोर
गेरुई	_onto_nodes	प्रतिधावन
जिलवाना	_hypernym	उत्तरायन
इंदुवल्ली	_hypernym	रेकॉर्ड_किया
अंबुजा	_onto_nodes	प्रतिधावन
संगसुरमा	_onto_nodes	न्यूज़_पेपर
बहिन	_onto_nodes	सृंजय
हानि	_onto_nodes	बिलल्ला
फैंटेसी	_onto_nodes	आँख_मूँदकर
अड़वाड़	_onto_nodes	अमानुष
लाल_अंजन	_onto_nodes	अवाकी
कुही	_hypernym	तंतुवाद्य
वसंततिलक	_onto_nodes	भुँइफोर
तुंगीश	_hypernym	घुड़कना
ब्रजभाषा	_onto_nodes	ईयर
सुलोहिता	_hypernym	नेपाली_रुपया
गूंगापन	_hypernym	रुफिया
शीतवल्क	_onto_nodes	सीकर
सङ्घात	_onto_nodes	भुँइफोर
जलशाला	_hypernym	टघराना
यू_एस_डालर	_onto_nodes	रखैया
स्वराक्षर_ऐ	_onto_nodes	सृंजय
आखेटक	_onto_nodes	सृंजय
तुर्कमेनी_भाषा	_hypernym	बिलल्ला
चेतनाहीन	_hypernym	सैदी
अमृतकुण्ड	_hypernym	अभिरना
लाजवाब	_onto_nodes	खपाची
एन्टीगुआ_और_बरबूडा	_hypernym	शकरख्वाब
व्यञ्जन_अक्षर_च	_onto_nodes	पिकाङ्ग
मसवदा	_hypernym	साओ_टोम_और_प्रींसिपे_जनतांत्रिक_गणराज्य
निश्चिरा	_hypernym	भयानक_रस
अपरान्तिका	_hypernym	धाव_पट्टी
फरमाँबरदारी	_hypernym	रेहुआ
अभिनंदन_पत्र	_onto_nodes	खपाची
रूखा	_hypernym	कृपासिंधु
जिंदा_हाथी_लाख_का_मरा_तो_सवा_लाख_का	_hypernym	उनतालीस
उद्देश्यता	_hypernym	जैन_धर्म
अघहरण	_hypernym	घोषणा
अयशत्य	_onto_nodes	अरसाना
विश्रांति_गृह	_onto_nodes	रङ्गमहल
कड़खा	_hypernym	ताल-मेल
साहु	_hypernym	ऊपरी_सिआंग_ज़िला
एकाक्षरोपनिषद	_hypernym	उन्नीसवीं
घटी	_onto_nodes	पूर्णचाँद
साल-ब-साल	_onto_nodes	अवाकी
जोजन	_hypernym	पुष्टता
आयुध_विधान	_onto_nodes	भुँइफोर
काँग्रेसी	_hypernym	सैरसपाटा
विपदाग्रस्त	_onto_nodes	सीकर
औषध_विज्ञान	_hypernym	अब_तब_करना
खुर	_onto_nodes	रङ्गमहल
इंडोआर्यन	_onto_nodes	बिलल्ला
कोरबा	_onto_nodes	भुँइफोर
तँबियाना	_hypernym	रियायत
आलतू-फालतू	_onto_nodes	भुँइफोर
हेलुआ	_hypernym	ताल-मेल
शिक्षा_प्रेम	_onto_nodes	बहवाना
वाहियात	_onto_nodes	भुँइफोर
परिलक्षित	_onto_nodes	सृंजय
फ़ीरोज़ी	_hypernym	फलकावन
बैसाख	_onto_nodes	ईयर
व्यापारिक_दस्तावेज	_onto_nodes	माफी_देना
आस्फोटक	_onto_nodes	ख़रीता
अब्जबांधव	_hypernym	बिलल्ला
शेखीमार	_hypernym	पंजा
आंतरिक_शक्ति	_onto_nodes	खपाची
अँकौर	_onto_nodes	प्रतिधावन
चाँटा_मारना	_onto_nodes	मेक्सिको
भंजक	_attributes	यूक्रेन-वासी
अधिमानतः	_onto_nodes	बहवाना
संयुक्त_राष्ट्र	_hypernym	अमीबा
सूजन	_hypernym	गुड़गाँव_शहर
सैर-सपाटा	_onto_nodes	पिछलगा
पाक-शैली	_onto_nodes	सृंजय
कर्षण_नौका	_hypernym	अधिकार-रहितता
मूँठदार	_onto_nodes	भुँइफोर
अप्रासांगिक	_hypernym	सबल
कवरत्ती	_onto_nodes	रङ्गमहल
वीर्यरहित	_onto_nodes	रङ्गमहल
अपवादक	_onto_nodes	ईयर
प्रसङ्गहीन	_hypernym	नरपति
कोक्राझार_जिला	_onto_nodes	ईयर
धुअँठना	_hypernym	टेलिफून
अदण्डित	_onto_nodes	सत्यसन्ध
प्रतिलेख	_hypernym	स्मृति_चिह्न
प्रसूत_होना	_hypernym	नतिनी
प्रतिष्ठान	_onto_nodes	साया
इत्तफ़ाक़_रखना	_onto_nodes	मेक्सिको
सितारी	_hypernym	बिलल्ला
जिक्र	_onto_nodes	ज्येष्ठत्व
शोकपूर्णता	_hypernym	फेनदार
हिमकण	_hypernym	त्रिशिख
संकल्पनाकोश	_onto_nodes	भुँइफोर
डिप्लोमा	_onto_nodes	तुरंगिका
हुल्लड़बाज़ी	_onto_nodes	खपाची
वैनेजुएला	_hypernym	कड़ुआपन
अस्र	_onto_nodes	भुँइफोर
जीवाणुरोधी	_onto_nodes	ज्येष्ठत्व
वृद्धविभीतक	_hypernym	विश्वस्तर
कसब_कमाना	_hypernym	सामर्थ्य_शक्ति
शस्ति	_hypernym	ठाणा_जिला
अप्रवर्तक	_onto_nodes	पैरदान
फ़्रिजीया	_hypernym	उल्टा_पैदा
आपही	_hypernym	टेलीविज़न_चेनल
जिज़िया	_onto_nodes	खानेवाला
कुशल	_hypernym	टेलिफून
वारंगल_ज़िला	_onto_nodes	सृंजय
सार्थकता	_hypernym	प्रशिक्षणार्थी
खँघारना	_hypernym	लोलुप
खँजरी	_hypernym	नरपति
उत्तरी_त्रिपुरा_ज़िला	_onto_nodes	व्यास
केंद्रीय_स्नायुप्रणाली	_onto_nodes	सीरियाई_पौंड
रसोइया	_onto_nodes	मुखशोधन
_अखंड	_onto_nodes	सृंजय
रीसीट	_onto_nodes	सृंजय
एकसमान	_onto_nodes	संगीतात्मक
जुग	_onto_nodes	बहवाना
एरनॉटिक्स	_hypernym	धुबरी_शहर
अपति	_hypernym	अनन्तकाय
अप्रासंङ्गिक	_onto_nodes	सीकर
पानस	_hypernym	बिलल्ला
अच्युत	_hypernym	पुष्टता
कोई	_hypernym	अव्यतीत
जीवनसङ्गी	_onto_nodes	सीकर
दुधारू	_onto_nodes	सृंजय
सगर्भ	_hypernym	अभिरना
टिघलना	_hypernym	टेलिफ़ोन
अर्ग्वध	_hypernym	मड़ुवा
क्वेन्च_करना	_hypernym	ठाणा_जिला
प्रतिप	_onto_nodes	साया
हवाईअड्डा	_onto_nodes	अन्न_ग्रहण
गलफेड़ा	_onto_nodes	सीकर
खरचना	_onto_nodes	सीकर
हमाल	_onto_nodes	व्यास
झिंगाक	_onto_nodes	न्यूज़_पेपर
भों	_onto_nodes	अन्न_ग्रहण
गोवालपारा	_onto_nodes	सत्यसन्ध
चित्रांगदा	_onto_nodes	अवाकी
उग्रगंधामूल	_hypernym	गोचरपिण्ड
पत्नीव्रता	_hypernym	श्वेतकांडा
प्रेमपूर्ण	_onto_nodes	खपाची
बाणगङ्गा_नदी	_onto_nodes	जेठानी
आँटी	_hypernym	टंकित
ख़ुशनसीब	_onto_nodes	भुँइफोर
पद्माट	_onto_nodes	साया
बेनतीजा	_hypernym	रेहुआ
रोचि	_hypernym	बुज़दिल_व्यक्ति
मुनियाँ	_hypernym	बाहर_आना
नई_बहू	_onto_nodes	सीकर
रुचिप्रभ	_onto_nodes	बाणगङ्गा_नदी
अवधिहीन	_hypernym	घुड़कना
तुर्क़मेनी_मनत	_onto_nodes	न्यूज़_पेपर
एमडी	_onto_nodes	नन्दा
ममियाउत_भाई	_hypernym	देह
सर्व_प्रथम	_onto_nodes	साया
अमानुषिकता	_onto_nodes	अवात
रामगंगा	_hypernym	अंतावसायी
रत्न_मंजूषा	_onto_nodes	बहवाना
मूंदना	_onto_nodes	अनिष्टकर
अनुक्षेत्र	_hypernym	अनभीष्ठ
कॉलेज	_hypernym	साओ_टोम_और_प्रींसिपे_जनतांत्रिक_गणराज्य
मृत्यु_दर	_onto_nodes	संगीतात्मक
वार्णिक-गण	_onto_nodes	अवाकी
ऐंप्यूल	_attributes	कटहल
प्रपितामह	_hypernym	हरफ़न_मौला
सोनीपत	_onto_nodes	भुँइफोर
पाठ्यक्रम	_onto_nodes	भुँइफोर
अविभाजित_अंश	_onto_nodes	चोरबदन
आकाशयान_सेवा	_hypernym	रेहुआ
रेलवे	_hypernym	निलसिर
नेशनल_सिक्युरटी_काउंसल	_hypernym	बिलल्ला
टप्पा_पड़ना	_hypernym	ढुवारा
खुसफुसाहट	_onto_nodes	बहवाना
चन्द्र_बिम्ब	_onto_nodes	गड़गड़ा
गौरवान्वयन	_onto_nodes	अनिष्टकर
सूडानीस_पौंड	_hypernym	ठाणा_जिला
सैनिक_कार्रवाही	_hypernym	मूत्रदोष
हैमन	_onto_nodes	आँख_मूँदकर
ज़र्दी	_onto_nodes	सृंजय
पिंडबीजक	_onto_nodes	खपाची
कुहुकबान	_hypernym	पिचपिचाहट
प्रथम_उपचार	_onto_nodes	साया
वेस्टकोट	_onto_nodes	भुँइफोर
जाम्बवती	_hypernym	पाककर्म
इन्टरफ़ेस	_hypernym	लिप्ता
वायरसरोधी_औषधि	_onto_nodes	संगीतात्मक
अनमापा	_hypernym	गोचरपिण्ड
बेपर्दा	_onto_nodes	भुँइफोर
सदी	_hypernym	दीर्घलोचन
रुद्र-हृदय	_onto_nodes	अमानुष
अवगाढ़	_onto_nodes	तुरंगिका
दूरसंचार	_onto_nodes	साया
उपजाति	_onto_nodes	भुँइफोर
पूतिमूषिका	_onto_nodes	छलशून्यता
गुप्त_वंश	_hypernym	कलहन्तारिता
छत्त	_onto_nodes	खपाची
पूरापन	_onto_nodes	लोक-साहित्य
धधक	_hypernym	पाककर्म
दानेदार	_hypernym	चुलबुला
शख़्स	_hypernym	भूमिगत_रेल_मार्ग
गिरिगुहा	_onto_nodes	इतेक
असुलभता	_onto_nodes	मोतियदाम
नलसाज़ी	_onto_nodes	बहवाना
पन्नग	_onto_nodes	भुँइफोर
संगाय	_onto_nodes	भरतनाट्यम्_नृत्य
करैल	_onto_nodes	अवाकी
मुसटी	_hypernym	सोने_में_सुहागा_होना
मित्रविन्द	_onto_nodes	तुरंगिका
यूरोपी	_onto_nodes	साया
शुभंगी	_hypernym	सँभलना
बेलोज	_onto_nodes	सीकर
दीर्घमता_ऋषि	_onto_nodes	चंद्राकार
दिखु	_hypernym	जलीय-जंतु
धातुपुष्पी	_onto_nodes	सीकर
सम्राट_अशोक	_hypernym	जंतुशास्त्री
आपस्तंब_ऋषि	_hypernym	पाककर्म
पारुष्य	_hypernym	प्रधानमंत्री
किरगिज	_hypernym	निलसिर
प्रमाणित	_onto_nodes	सत्यसन्ध
स्लोवीनिया	_onto_nodes	बांदीपुरा
उत्तीर्ण	_onto_nodes	भुँइफोर
अहसास	_hypernym	बैताल_पचीसी
पत्ता_साफ_करना	_hypernym	कण्टकाल
फारस	_hypernym	भू-वायु
विपाटद्वार	_hypernym	इतिवृत्त
लता_मंगेशकर	_hypernym	धाव_पट्टी
बुलगारियाई_लिपि	_onto_nodes	सीकर
उखड़ाना	_hypernym	पब्लिक_प्रॉसिक्यूटर
संतूर	_hypernym	नरपति
हांग_कांग	_hypernym	ताल-मेल
सोनावल्ली	_hypernym	नक़लची
चालना	_hypernym	इतिवृत्त
अमुख्य	_onto_nodes	बांदीपुरा
डेनमार्की_क्रोना	_hypernym	शतपथी
नरसेज	_onto_nodes	सीकर
अनवगाह	_onto_nodes	संगीतात्मक
नृतक	_hypernym	वाह्लीक_घोड़ा
अन्त्याक्षरी	_hypernym	रियाज
बहामाज़	_hypernym	प्रसूति_काल
डोकिया	_hypernym	नरपति
जसोमति	_onto_nodes	खपाची
लक्समबर्ग_सिटी	_onto_nodes	रङ्गमहल
सुकेशी	_onto_nodes	अरसाना
राज्यतंत्र	_hypernym	आयोधन
छाल	_onto_nodes	सूपाबेना
श्वेताद्रि	_hypernym	मूँठदार
रुमाल	_hypernym	सह_संक्रमण
जुतियाना	_onto_nodes	साया
वर्ल्ड-वॉर_I	_onto_nodes	खपाची
आलस्य_भरा	_hypernym	निष्कंटक
साहिबजादा	_onto_nodes	इतेक
योग_निद्रा	_hypernym	पब्लिक_प्रॉसिक्यूटर
तननेवाला	_onto_nodes	अनतुला
कनपटी	_hypernym	प्रक्षेपास्त्र
शूकवती	_hypernym	अजननिका
तई	_onto_nodes	भुँइफोर
एल_सल्वाडोर_गणराज्य	_hypernym	बिलल्ला
अक्षयता	_hypernym	संबंध_होना
भृगु	_hypernym	सालोमन_द्वीप_समूह
इंदर	_hypernym	प्रत्यूस
प्रहेलक	_onto_nodes	साया
अँगरी	_onto_nodes	पदासन
अपेंडिक्स	_hypernym	तन्त्रशोधित
नीलांजसा	_onto_nodes	सृंजय
डग्गा	_hypernym	जाति-वाचक
कुषुंभ	_onto_nodes	मेक्सिको
थिरथिर-कंपानी	_onto_nodes	ज्येष्ठत्व
निर्गुंडी	_hypernym	ऐशोआराम
दिशापति	_hypernym	सहलाई
वर्णिक_छंद	_hypernym	भूविज्ञानी
उर्वर	_hypernym	तंत्रशास्त्र
तड़ित्पति	_hypernym	सिन्दूरिया
यामिन	_onto_nodes	अनिष्टकर
अमररत्न	_onto_nodes	ईयर
सङ्घात	_hypernym	अबन्धु
मूत्रदोष	_onto_nodes	मेक्सिको
सन्दूकचा	_hypernym	विदीर्ण
जाबालोपनिषद	_hypernym	सरसरी_नजर_डालना
दंड_प्रणाम	_onto_nodes	खपाची
जलाभिषेक	_hypernym	महन्त
पौराणिकी	_onto_nodes	भुँइफोर
बरमूडन	_hypernym	करारना
प्राणाग्नि-होत्र_उपनिषद्	_onto_nodes	व्यास
प्रसरण	_onto_nodes	भुँइफोर
कीर्त्तिशाली	_onto_nodes	अमानुष
अभिभाष्य	_onto_nodes	अविपर्यय
ईंडवी	_onto_nodes	खपाची
विंडहोक	_onto_nodes	साया
तंतु_वाद्य	_hypernym	ग़मी
गनेल	_hypernym	भीड़ना
आधारिक_संरचना	_onto_nodes	भुँइफोर
बाजारू	_onto_nodes	भुँइफोर
आखिरी	_hypernym	अवलुंचित
ढालिया	_onto_nodes	माहेंद्रवाणी_नदी
गंदा_होना	_onto_nodes	व्यास
स्तंभ	_onto_nodes	ज्येष्ठत्व
पवित्रोपान-एकादशी	_onto_nodes	व्यास
पारसी_धर्म	_onto_nodes	प्रतिधावन
सिएरा_लिओने-वासी	_onto_nodes	रङ्गमहल
पारसी	_hypernym	रक्तवर्ण
शिवाह	_onto_nodes	लोक-साहित्य
कार्यपालिका	_onto_nodes	अरदल
वैवस्वती_नदी	_hypernym	बिलल्ला
नरभक्षक	_hypernym	अलेक्ज़ेन्ड्रिया
शाकभक्ष्य	_onto_nodes	रङ्गमहल
विवाह_करवाना	_hypernym	कद-काठी
नक्शानवीसी	_onto_nodes	मेक्सिको
तंतु-कीट	_hypernym	अगति
सिरसा_शहर	_onto_nodes	सत्यसन्ध
तेजी_आना	_hypernym	नाज़ुक_बाल
रक्तकंठ	_hypernym	धाव_पट्टी
फनकार	_onto_nodes	अवाकी
वृद्धराज	_entailment	जनता-दल_यूनाइटेड
शापनिवारण	_hypernym	शुदनी
जल-स्नान	_onto_nodes	सृंजय
दण्डनीति	_hypernym	चूहामार_बाज
पूर्व_गारो_हिल्स_जिला	_onto_nodes	पूर्णचाँद
उढ़ुकना	_hypernym	सुकेशी
उण्डी	_onto_nodes	आईआईटी
मौज_मस्ती_भरा_आरामदायक_जीवन_जीना	_hypernym	स्केजुल
भट	_hypernym	अवक्रय
अंबाहल्दी	_hypernym	सिलिकन
टैगलॉग	_hypernym	रेकॉर्ड_किया
बैलेट_पेपर	_onto_nodes	शीघ्र
सत्यनिष्ठा	_hypernym	कोरी
अनुबन्धकर्त्ता	_onto_nodes	व्यास
सी_आई_डी	_onto_nodes	छलशून्यता
सिलखरी	_onto_nodes	भुँइफोर
इंगुद	_hypernym	नियंत्रण_करना
जीवनकाल	_onto_nodes	ईयर
भलमनसाहट	_hypernym	ठाकुर_रवीन्द्रनाथ_टैगोर
अजितेन्द्रिय	_hypernym	भू-वायु
आडिटर	_hypernym	धनबाद
मणीचक	_onto_nodes	अवाकी
फेंकाना	_hypernym	अभिप्रणय
ओसर	_hypernym	काबिलेदाद
चेक_गणराज्य	_hypernym	वल्वग
परिकलक	_onto_nodes	पूर्णचाँद
पितरिहा	_hypernym	जलरंड
अरयारी	_hypernym	अधिरोहण
दोहाई	_hypernym	सिएरा_लिओनी
उद्भिज्ज	_hypernym	नरपति
ढेर	_hypernym	मुंतजिर
सद्_व्यवहार	_onto_nodes	अविपर्यय
एक_बार_में	_onto_nodes	सीकर
बुरकना	_hypernym	अभिरना
विद्यापीठ	_hypernym	हक़ारत
अनंतनाग_ज़िला	_onto_nodes	बाणगङ्गा_नदी
छुरीधार	_onto_nodes	ईयर
परम्परा-वाद	_onto_nodes	मोतियदाम
अर्धनारीश्वर	_onto_nodes	सीकर
सविस्तार	_onto_nodes	सृंजय
गोलंदाज	_onto_nodes	चोरबदन
अर्सी	_hypernym	पोषकत्व
डच_गुएना	_onto_nodes	अमानुष
त्रिभुवनसुन्दरी	_hypernym	शमशान_घाट
जलरंकु	_hypernym	नेपोलियन_बोनापार्ट
कान_फटना	_onto_nodes	अवाकी
आर_टी_ई	_onto_nodes	भुँइफोर
सकारात्मक	_hypernym	निस्तारक
चार्ल्स_फ्रान्सिस_हॉल	_onto_nodes	छलशून्यता
कारगुज़ार	_onto_nodes	ज्येष्ठत्व
बटमारी	_hypernym	बिलल्ला
भूतबाधाग्रस्त_आदमी	_onto_nodes	ख़रीता
नगनिका	_hypernym	गुल्मरोग
भुइँकाँड़ा	_onto_nodes	चालचलन
कोरियाई_भाषा	_onto_nodes	अवाकी
पाद_छोड़ना	_hypernym	बिलल्ला
थोथापन	_onto_nodes	सृंजय
भभूति	_onto_nodes	अतरवन
न्यून_होना	_onto_nodes	खपाची
मेयोनीज़	_hypernym	रेकॉर्ड_किया
गलत_चिह्न	_onto_nodes	अवाकी
पानीपत_की_तीसरी_लड़ाई	_onto_nodes	सत्यसन्ध
न्यू_साउथ_वेल्स	_onto_nodes	साया
स्वैजीलैंड	_onto_nodes	मेक्सिको
रपाती	_hypernym	गिट्टक
श्वसन-प्रणाली	_hypernym	कोरी
तीसवाँ_साल	_hypernym	सीमोल्लंघन
सीया	_hypernym	बिलल्ला
पहले_जैसा_करना	_hypernym	ठाणा_जिला
टूवैलू	_onto_nodes	भुँइफोर
धनुर्भृत	_hypernym	जीवित
शेखीखोर	_onto_nodes	चंद्राकार
नृपप्रिया	_hypernym	घर्रा
ख़बरदार_करना	_hypernym	नरम_नरम
मक्कल_रोग	_onto_nodes	भुँइफोर
आरोपित	_hypernym	_ग्वाटेमाला_गणतन्त्र
दक्षिणी_कोरिया_गणराज्य	_onto_nodes	भुँइफोर
डंकीला	_hypernym	रिवायत
इश्क-बाज	_onto_nodes	अवाकी
सुन्दरबन	_onto_nodes	बाणगङ्गा_नदी
गुठली	_onto_nodes	व्यास
दिन_रात	_hypernym	धाव_पट्टी
तार्क्ष्यकेतन	_onto_nodes	झटा_झट
कठिन	_onto_nodes	खपाची
लज़्ज़त	_onto_nodes	अवाकी
अनिरूपित	_hypernym	चिटकना
वार्षिकी	_onto_nodes	आईआईटी
टाशकेंट	_onto_nodes	बाणगङ्गा_नदी
रघुबर	_hypernym	नंदिका
धातु	_hypernym	लगलग
संचालन	_hypernym	नरपति
मूँड़ीबंध	_hypernym	कुमुदिनी
सिंघाडा	_onto_nodes	खपाची
दीन-पालक	_hypernym	साओ_टोम_और_प्रींसिपे_जनतांत्रिक_गणराज्य
इज्जतदार	_onto_nodes	साया
गलन	_hypernym	पाककर्म
मेहतरानी	_hypernym	उघढ़ना
गण्डमाला	_onto_nodes	न्यूज़_पेपर
सदृश	_hypernym	रणभूमि
सन_सन	_hypernym	ईडी
पूरबी	_onto_nodes	साया
अंतर्मुख	_onto_nodes	ज्येष्ठत्व
मृत्युकारी	_onto_nodes	बांदीपुरा
सादर	_hypernym	रिवायत
बेग़म	_onto_nodes	बहवाना
उतारा	_hypernym	पलायनवाद
आचारी	_onto_nodes	सृंजय
पूर्णेंदु	_hypernym	गिट्टक
मार्जक	_hypernym	नरपति
अजपा	_hypernym	रेवा_शहर
नन्दरानी	_onto_nodes	व्यास
निवृत्त_वेतन	_onto_nodes	संगीतात्मक
पिण्डज_जन्तु	_onto_nodes	सत्यसन्ध
पॉलीएस्टर	_hypernym	काँकड़ासिंगी
बुलगारिया_गणराज्य	_hypernym	रोचिसा_ऋषि
अदल-बदल	_onto_nodes	अवाकी
हिरण्यकशिपु	_hypernym	उनतालीस
दक्खिन_प्रदेश	_onto_nodes	सूपाबेना
बड़कन्ना	_onto_nodes	अवाकी
निष्पादित	_onto_nodes	लोक-साहित्य
पुत्रवान्	_hypernym	गोचरपिण्ड
अमाईताल	_onto_nodes	खपाची
सिपहसालार	_onto_nodes	अवाकी
निकल	_onto_nodes	सृंजय
तन्जावुर_शहर	_onto_nodes	सीकर
दमोड़ा	_onto_nodes	45
मूषिका	_onto_nodes	मेक्सिको
अपराधी_जाँच-पड़ताल_विभाग	_hypernym	मूसलाधार_पानी_बरसना
दक्ष_प्रजापति	_onto_nodes	कलहंतारिता
कर्तृका	_hypernym	परलोक_सिधारना
फलीदार	_onto_nodes	अनिष्टकर
चुसकी_लेना	_onto_nodes	सत्यसन्ध
ढकोसलेबाज़	_hypernym	घाटिया
कण्ठी	_onto_nodes	सृंजय
रोमरंध्र	_onto_nodes	भुँइफोर
केन्द्रीय_खुफिया_एजेंसी	_onto_nodes	बहवाना
सुधनु	_hypernym	जलन्धर
बालपन	_hypernym	नाज़ुक_बाल
बालधी	_hypernym	शपथ
चौबीसवाँ_साल	_hypernym	हक़ारत
कराइकल_जिला	_onto_nodes	अवाकी
मटकोड़वा	_hypernym	सबल
विश्वगर्भ	_hypernym	हंसी-मज़ाक़
तक़लीफ़_उठाना	_hypernym	अनुवाद_करना
मिलिट्री	_onto_nodes	सृंजय
सलीक़ेमंद	_hypernym	क्षीणक-रोग
असुरसेन	_onto_nodes	संगीतात्मक
दैहिक	_onto_nodes	न्यूज़_पेपर
उल्काश्म	_hypernym	नरपति
पुलाव	_hypernym	धुबरी_शहर
गोलांगूल	_onto_nodes	सत्यसन्ध
द्रोणपुत्र	_onto_nodes	खपाची
ऊसर_जमीन	_hypernym	आवेदित
शादी_कराना	_onto_nodes	रङ्गमहल
एकलौता	_hypernym	प्रसूति_काल
नीतिपूर्ण	_onto_nodes	अवाकी
केलांग	_onto_nodes	रङ्गमहल
डोंड़ी	_hypernym	कंपिल
पास_करना	_hypernym	सीमोल्लंघन
देवरानी	_onto_nodes	चंद्राकार
आदान	_hypernym	क्रुज़ेरिओ
अप्रतिम_सौंदर्य	_onto_nodes	सीकर
फ़िल्मकार	_onto_nodes	भुँइफोर
अधर्मिष्ठ	_hypernym	मादा_कोश
तंबूर	_onto_nodes	बांदीपुरा
भावनोपनिषद	_attributes	अधीन_करना
वलाट	_hypernym	ताल-मेल
अनाच्छादित	_hypernym	कुमंत्रणा
आत्मबोध_उपनिषद्	_hypernym	एन्टिना
धर्मावलंबी	_onto_nodes	प्रतिधावन
नावाकिफ	_onto_nodes	सृंजय
कर्फ्यू	_onto_nodes	चालचलन
चान्द्र-वर्ष	_hypernym	इअरफोन
शर्त	_hypernym	महात्मा_गाँधी
60	_onto_nodes	साया
श्वैत्र	_onto_nodes	झटा_झट
निषदन	_hypernym	अतृप्त
मुनाफ़ाख़ोर	_onto_nodes	तुरंगिका
अभ्यञ्जनीय	_onto_nodes	साया
नागांतक	_hypernym	रिवायत
अँगोछना	_onto_nodes	बहवाना
आर्मी	_onto_nodes	भुँइफोर
अमचूर	_hypernym	रणभूमि
बाज़ूबन्द	_onto_nodes	भुँइफोर
टाँका_लगाना	_hypernym	चूअरी
अमृतलतिका	_hypernym	विकृति
भीलवाड़ा	_onto_nodes	भुँइफोर
ऊँटकटारा	_hypernym	प्रत्यर्पण
भठियाल	_onto_nodes	भुँइफोर
कार्बी_आंगलांग_ज़िला	_hypernym	सह_संक्रमण
लुत्फ़_उठाना	_onto_nodes	खपाची
मुखमाधुर्य	_onto_nodes	अवाकी
मधुर	_hypernym	भागासुर
रक्तचन्दन	_hypernym	एवरेस्ट
बासून	_hypernym	वर्द्धमान_शहर
रहन-सहन	_hypernym	फलवान
स्त्री_जननांग	_onto_nodes	संगीतात्मक
परदादी	_hypernym	अभिप्रणय
नरसिंहा	_hypernym	रामनामी
तंबू-पर्दा	_onto_nodes	मेक्सिको
अनुवर्तन	_hypernym	पाककर्म
गर्भनाल	_onto_nodes	सीकर
कल्याणकारी	_onto_nodes	जीर्ण-शीर्ण
अमरखी	_hypernym	प्रसूति_काल
केंद्रीय	_onto_nodes	भुँइफोर
सिंहलक	_hypernym	रापी
मैसूर_स्टेट_बैंक	_hypernym	अभिव्यक्तिशील
अनपाश्रय	_onto_nodes	संगीतात्मक
टिंचर-स्टील	_hypernym	देह
जोरहट_शहर	_onto_nodes	रङ्गमहल
रिक्रूट्मेन्ट	_onto_nodes	भुँइफोर
सौतेली_माँ	_onto_nodes	तुरंगिका
ऑलराउन्डर	_onto_nodes	भुँइफोर
स्वयंवरा	_hypernym	खूसट
हवन	_hypernym	निरालंब
सारिवा	_onto_nodes	अवाकी
नीलकमल	_onto_nodes	सृंजय
मनु-स्मृति	_hypernym	श्वेतकांडा
शीतकटिबन्ध	_hypernym	प्रसूति_काल
कंकरीट	_onto_nodes	आईआईटी
गूँथा_हुआ	_hypernym	प्रसूति_काल
अनवद्या	_hypernym	भीमकुण्ड
पालकाप्य	_onto_nodes	भुँइफोर
आभीर	_hypernym	आर्टिफिशल
ग़ालिब	_hypernym	श्रवनीय
शैलीगत_करना	_onto_nodes	भुँइफोर
एकाह_यज्ञ	_hypernym	नींद_उड़ना
परिहार	_onto_nodes	साया
पंक_रॉक	_hypernym	कोरी
डबलिन	_onto_nodes	सूपाबेना
मंचन	_hypernym	शतपथी
झुलमुली	_hypernym	प्रत्यर्पण
अनुकंपा_राशि	_onto_nodes	आईआईटी
रेल_परिवहन_स्थल	_onto_nodes	इतेक
तोशाख़ाना	_onto_nodes	भुँइफोर
पंचभर्तारी	_onto_nodes	संगीतात्मक
कपोतव्रत	_onto_nodes	परियोजना
घनफुट	_hypernym	अधबयसू
पैनावू_शहर	_onto_nodes	सृंजय
आकस्मिक_निधि	_hypernym	अनुवासन
नियम_धारा	_onto_nodes	खपाची
अनार्य_जाति	_hypernym	कुपवाड़ा_शहर
दोहदोन्विता	_hypernym	अभिरना
जैसे_तैसे	_hypernym	चमन
निरोध	_onto_nodes	भुँइफोर
प्रसिद्ध	_hypernym	निरालंब
योगकुंडलिनि_उपनिषद	_onto_nodes	अनिष्टकर
पसरना	_onto_nodes	सृंजय
कैरट	_hypernym	रग्बी
अनध्यवसाय	_onto_nodes	अंतरिक
वृथारुदन	_onto_nodes	चंद्राकार
पर्यवेक्षण_धरहरा	_onto_nodes	संगीतात्मक
द्युति	_onto_nodes	सृंजय
जोताँत	_onto_nodes	सीकर
इस्तीफा	_onto_nodes	मुखशोधन
आयात-कर	_hypernym	अभिरना
वेदवती	_onto_nodes	संगीतात्मक
प्रौढ़	_hypernym	गोचरपिण्ड
टाँकना	_onto_nodes	सीकर
फकीरचंद	_onto_nodes	चोरबदन
आतर	_onto_nodes	प्रतिधावन
रमारमण	_hypernym	स्तनहार
निर्यातकर	_onto_nodes	तुरंगिका
दोतरफा	_hypernym	यू_एस_डालर
मुर	_hypernym	बिलल्ला
लाल_पांडा	_onto_nodes	भुँइफोर
दर्शनोपनिषद्	_hypernym	श्वसनतंत्र
महन्त	_onto_nodes	तुरंगिका
शुदनी	_onto_nodes	बहवाना
सफलता_हासिल_करना	_hypernym	सेनेगल
बरबाद	_onto_nodes	सीकर
अड़ूसा	_onto_nodes	बहवाना
खंडित	_hypernym	गिट्टक
मूल्य_वृद्धि	_onto_nodes	अवाकी
शुकेष्ट	_hypernym	ढहा
आजार	_hypernym	हाथ-कुर्सी
नाभि_छेदन	_hypernym	व्रण
अंचल	_hypernym	दिवसाभिसारिका
पिताजी	_onto_nodes	भुँइफोर
सितमगर	_onto_nodes	मेक्सिको
व्यान_वायु	_onto_nodes	अनिष्टकर
बुरी_चेष्टा	_onto_nodes	पूर्णचाँद
धुबरी_शहर	_onto_nodes	बहवाना
हरफनमौला	_onto_nodes	प्रतिधावन
खरी_खोटी_सुनाना	_onto_nodes	संगीतात्मक
पितराई	_onto_nodes	साया
ऐन्टीलोप	_onto_nodes	भुँइफोर
चरमपंथी	_hypernym	बिलल्ला
अभिगृहीत	_onto_nodes	सूपाबेना
न्यू_टेहरी	_onto_nodes	सीकर
नेत्री	_onto_nodes	रङ्गमहल
वस्तूत्प्रेक्षालंकार	_onto_nodes	इतेक
जोर_करना	_onto_nodes	मान्यताप्राप्त
अमहत्व	_onto_nodes	प्रतिधावन
आधिकारिक	_hypernym	नाज़ुक_बाल
लोकोपकार	_onto_nodes	साया
छैसठवाँ	_onto_nodes	छलशून्यता
अभिकल्पना	_hypernym	बिलल्ला
समाजसेवी	_hypernym	ब्रह्मरेख
अस्वास्थ्यवर्धक	_hypernym	अधिकार-रहितता
सबल	_hypernym	पेट्रोल
महाभारत_ग्रंथ	_onto_nodes	अवात
पश्च_भाग	_onto_nodes	खपाची
रोबोट	_onto_nodes	आईआईटी
हालैंडवासी	_hypernym	कमोबेश
संवर्धन	_onto_nodes	चोरबदन
बारबैडोस-वासी	_onto_nodes	साया
कृत्रिम_रूप_से	_onto_nodes	बहवाना
शुक्त्यंगी	_onto_nodes	ईयर
पायु	_hypernym	गोचरपिण्ड
अवनति	_hypernym	अरसाना
निरस्त्र	_onto_nodes	सूपाबेना
असालतन	_onto_nodes	खपाची
सेन्टीमीटर	_onto_nodes	खपाची
क्रेप	_hypernym	इठलाना
किमख्वाब	_hypernym	तिपाई
काकड़_आरती	_onto_nodes	बहवाना
अपरितोष	_onto_nodes	खपाची
शर्मसार	_onto_nodes	खपाची
विश्वधेनु_ऋषि	_onto_nodes	सृंजय
मुछियल	_hypernym	ठाणा_जिला
कंक्रीट	_onto_nodes	ज्येष्ठत्व
अनंतचतुर्दशी	_onto_nodes	खपाची
मवाली	_hypernym	वैजयंतीमाला
पवित्रा	_onto_nodes	टेलिफ़ोन_नंबर
अनुत्तम	_onto_nodes	भुँइफोर
नराधिप	_onto_nodes	भुँइफोर
पंचकुनिया	_onto_nodes	अरसाना
मल्ल_भूमि	_hypernym	सिंदूरपुष्पी
स्वास्थ्य_मन्त्रालय	_onto_nodes	भुँइफोर
गाली_देने_वाला	_hypernym	अवंति
व्यञ्जन_अक्षर_ङ	_onto_nodes	पिछलगा
अमूर्त	_hypernym	सलवार_कमीज
विलियम_शेक्सपियर	_hypernym	पेट्रौलपम्प
आइस_लॉली	_hypernym	धाव_पट्टी
शंखोदरी	_onto_nodes	भुँइफोर
विश्वासपूर्वक	_onto_nodes	सृंजय
चुगाना	_onto_nodes	बहवाना
जीवनचक्र	_hypernym	धाव_पट्टी
बाँसवाड़ा_जिला	_onto_nodes	सूपाबेना
पादा_नमक	_onto_nodes	सृंजय
अनधिगत	_onto_nodes	अनद्यतन
माहेंद्री	_onto_nodes	व्यास
अप्रतिगृहीत	_hypernym	गैर_कानूनी_धंधा
भटकटाई	_onto_nodes	अविपर्यय
डाउन	_hypernym	भूँ_भूँ
द्वापर_युग	_onto_nodes	सीकर
अनुवाद_कर्ता	_hypernym	कल्पित
इंस्ट्रक्शन	_onto_nodes	सृंजय
अनठानबेवाँ	_hypernym	प्रसूति_काल
रक्त_बैंक	_onto_nodes	बहवाना
धन्वाकार	_hypernym	टेलिफून
गांधीजी	_hypernym	पब्लिक_प्रॉसिक्यूटर
घड़ी_मिलाना	_hypernym	नकल_उतारना
इरविन	_onto_nodes	बहवाना
गुज्जर_जाति	_onto_nodes	अनतुला
आस्राव	_hypernym	सवारी
अदाकार	_hypernym	लगलग
एकाउन्ट_होल्डर	_onto_nodes	जार्जियाई-भाषा
तिलपट्टी	_onto_nodes	अवाकी
कुंदना	_onto_nodes	व्यास
अन्न-विकार	_onto_nodes	चंद्राकार
ताश_बूटी	_hypernym	बिलल्ला
आज्यपा	_hypernym	श्वेतकांडा
वायुकोण	_hypernym	हेयटी_द्वीप
शशभृत	_onto_nodes	पिछलगा
शास्त्रीय-संगीत	_onto_nodes	सृंजय
रूबल	_hypernym	गिट्टक
गिर्रिया	_onto_nodes	भुँइफोर
अदली	_hypernym	लोलुप
लेम्पिरा	_hypernym	सिन्धुलताग्र
ऐंप्यूल	_hypernym	सिरका
नलबारी	_entailment	तवक़्को
न्यू_टेहरी	_hypernym	विचाराधीन
उपयोग_होना	_hypernym	निलसिर
कश्यप	_hypernym	सुडान
वर्णिकछन्द	_onto_nodes	भुँइफोर
जिल्दबन्द	_hypernym	परलोक_सिधारना
वारि	_hypernym	परभणी_शहर
कपड़ा	_hypernym	आलमारी
निर्वाण_उपनिषद	_onto_nodes	साया
फनैन्सल	_onto_nodes	आईआईटी
ऐलान	_hypernym	सतसंग
पुत्रघ्नी	_onto_nodes	सूपाबेना
निडर	_onto_nodes	अवाकी
गविष्ठर	_hypernym	अपराधकर्ता
200	_onto_nodes	मेक्सिको
देश-निकासन	_hypernym	सम्प्रदान
इतस्ततः	_onto_nodes	ग्रोस
श्री_सत्य_साईं_बाबा	_hypernym	ईडी
चुरकना	_onto_nodes	सीकर
टाप	_onto_nodes	भुँइफोर
भाव_प्रवणता	_onto_nodes	साया
धुंधलाई	_hypernym	चूअरी
चीत्कार	_hypernym	आत्मसंतुष्ट
कांसा	_onto_nodes	ज्येष्ठत्व
जरत्कारू	_entailment	आमर्दन
वरली-चित्रकला	_onto_nodes	ग्रोस
एक्सरसाइज़	_onto_nodes	सृंजय
गड़ारी	_onto_nodes	सत्यसन्ध
धरी	_onto_nodes	खपाची
टेस्टर	_onto_nodes	प्रतिधावन
ग़र्ज़ी	_hypernym	ठाणा_जिला
राजसमंद	_hypernym	चूँ_चाँ
पिपरामिंट	_hypernym	अमुख्य
भ्रांतिशून्य	_onto_nodes	आईआईटी
गम-गम_करना	_hypernym	नरम_नरम
अभिमानपूर्वक	_onto_nodes	भुँइफोर
खरल_में_घोटना	_hypernym	समझ
चूड़ाम्ल	_hypernym	अच्छी_बात
मदनद्वादशी	_hypernym	सुंसारी
मुद्गल_उपनिषद्	_hypernym	सृंजय
सुरहीनता	_hypernym	अरागज
पृथुशेखर	_onto_nodes	अवाकी
अविना_भाव	_hypernym	धाव_पट्टी
अन्तरित	_hypernym	झांकी
राजस्थान_वासी	_hypernym	उनतालीस
डभकौरी	_hypernym	प्रसूति_काल
विकृति-विज्ञानी	_hypernym	डीएनए
सेली	_onto_nodes	ईयर
कलेऊ	_hypernym	दिफू_शहर
झारखण्ड_राज्य	_onto_nodes	भुँइफोर
जाम्बियावासी	_hypernym	खुरजी
किमख्वाब	_onto_nodes	साया
चाक्षुष_मनु	_onto_nodes	साया
इदानीतन	_onto_nodes	भुँइफोर
विख्यात	_hypernym	पनाला
वैद्यनाथ_बाबा	_hypernym	दिव्यसरिता
प्रमाता	_hypernym	आयोधन
गभस्तिहस्त	_hypernym	अभिरना
कंठ_बंध	_hypernym	रणभूमि
बाधित_करना	_onto_nodes	ग्रोस
धातु-विज्ञान	_onto_nodes	ईयर
विद्यालयीन	_onto_nodes	खपाची
टंगना	_onto_nodes	बहवाना
अधर-बिम्ब	_hypernym	बखैरीयत
संशयोपमा	_onto_nodes	बहवाना
अकर्मठ	_hypernym	पंजा
बंदूकची	_onto_nodes	बड़ा
अतुलित	_hypernym	खरका
अमृतसार	_hypernym	ताल-मेल
कीटनाशक	_attributes	बरुण्डीवासी
उफ़नना	_hypernym	शिल्पविद्या
गाबाँ	_hypernym	अभिस्यन्दी
यमनी_रीयाल	_onto_nodes	सृंजय
किरुंडी	_onto_nodes	सृंजय
वशीकृत	_onto_nodes	सीकर
मोतियाबिन्द	_onto_nodes	भुँइफोर
बम-मार	_hypernym	अनाच्छादन
संसृष्ट	_onto_nodes	साया
बुधवार	_onto_nodes	चंद्राकार
सफेद_पोश	_onto_nodes	भुँइफोर
ससुरखदेरी_नदी	_hypernym	सिंदूरपुष्पी
शयनैकादशी	_hypernym	मातृ-भाषा
मलयालम_लिपि	_hypernym	अबीरा
सञ्जीवनी	_hypernym	आर्थिक_दोहन
विधवाश्रम	_onto_nodes	चालचलन
बचा	_onto_nodes	ज्येष्ठत्व
अस्थिसुषिरता	_onto_nodes	टेलिफ़ोन_नंबर
टिंचर	_hypernym	दोग़ला
कंट्रोल_करना	_hypernym	गोचरपिण्ड
अकाउन्टेन्ट	_onto_nodes	ज्येष्ठत्व
मुक़दमा_चलाना	_onto_nodes	सीकर
पानीपत_की_दूसरी_लड़ाई	_onto_nodes	सीकर
मिरची_चूर्ण	_onto_nodes	सृंजय
जान_राय_मेजर	_hypernym	उनतालीस
बिलारी	_hypernym	कूआँ
अप्रसाद	_onto_nodes	प्रतिधावन
थू_थू_करना	_onto_nodes	चालचलन
अपर्याप्तता	_onto_nodes	प्रतिधावन
अवांछनीयता	_hypernym	ब्रिटिश_गयाना
वृद्ध_होना	_onto_nodes	पैरदान
नपुंसक	_onto_nodes	ईयर
रसरा	_hypernym	बैकुण्ठ
दिठौना	_hypernym	अति_बलिष्ठ
लावक	_onto_nodes	संगीतात्मक
उघाड़ी	_onto_nodes	साया
विश्रान्ति	_onto_nodes	सत्यसन्ध
एफपीओ	_hypernym	सह_संक्रमण
देवगण	_hypernym	सम्पुट
ठेहा	_hypernym	पब्लिक_प्रॉसिक्यूटर
जवां	_hypernym	पुष्टता
स्थलाकृति	_onto_nodes	सृंजय
कर्णपूर्व_ग्रन्थि	_hypernym	निलसिर
मसिकूपी	_onto_nodes	अवात
थायमिन_हाइड्रोक्लोराइड	_hypernym	भूप
निडरपन	_onto_nodes	अवाकी
तैली	_hypernym	मुनिपुत्र
उत्तम_ग्रंथकार	_hypernym	कोरी
डिसनिया	_hypernym	मसलन
अध्यापिका	_onto_nodes	तुरंगिका
ढेचा	_hypernym	अभिप्रणय
शशाङ्कज	_hypernym	मसलन
इंडियन_इंस्टीट्यूट_ऑफ_टेक्नालॉजी	_onto_nodes	संगीतात्मक
सोदर	_onto_nodes	लेज़िम_नृत्य
रँगाई	_hypernym	अजननिका
वारंगल	_hypernym	लगलग
रौद्र	_hypernym	ठाणा_जिला
अरजी	_onto_nodes	भुँइफोर
दृष्टिपटलविकृति	_onto_nodes	साया
इंजिनियर	_hypernym	नरपति
चिपड़ी	_hypernym	चमचा_चोंच
भानुसुता	_hypernym	बड़लाई
संघर्षशील	_hypernym	चिटकना
टिकई	_onto_nodes	साया
अप्सरेश	_hypernym	प्रेम
अशौच	_onto_nodes	कलहंतारिता
यवनिका	_onto_nodes	तुरंगिका
जींद	_onto_nodes	अनतुला
एल्क	_onto_nodes	भुँइफोर
क्षीर-सागर	_onto_nodes	इतेक
विदिशा_ज़िला	_onto_nodes	बहवाना
सजीला	_onto_nodes	संगीतात्मक
उद्घाटन	_onto_nodes	खानेवाला
समाधित	_onto_nodes	सीकर
सिनेगॉग	_onto_nodes	चंद्राकार
भूमंडलीय	_hypernym	इकतारा
अविभाजित	_hypernym	सदुपयोग
तालवाद्य	_onto_nodes	झटा_झट
मंसा_जिला	_hypernym	ध्यानबिंदु
व्यञ्जनाक्षर_ट	_hypernym	उनतालीस
काव्य	_hypernym	दुर्बोध
इशरत	_onto_nodes	अनिष्टकर
स्टेट_बैंक_ऑफ_पटियाला	_onto_nodes	प्रतिधावन
सामंती	_onto_nodes	मुखशोधन
बनासकाण्ठा_ज़िला	_hypernym	फलवान
सीवान_शहर	_hypernym	उनतालीस
तमाल	_onto_nodes	रङ्गमहल
गींजना	_hypernym	आनर्त्त-नगरी
शुल्क	_onto_nodes	खपाची
बंग्लादेशी	_onto_nodes	सुदिन
बीमार_होना	_hypernym	नाज़ुक_बाल
आसमान_टूट_पड़ना	_onto_nodes	सत्यसन्ध
एकत्रित	_onto_nodes	बहवाना
निष्पाप	_hypernym	रेकॉर्ड_किया
नमक्कल_ज़िला	_hypernym	डगडोलना
संवातन	_onto_nodes	ज्येष्ठत्व
अलग_रक्षित_करना	_hypernym	सबल
वरानन	_onto_nodes	रङ्गमहल
बिगुलची	_hypernym	पीलीभीत
अरागज	_onto_nodes	भुँइफोर
पुराणीय_व्यक्ति	_hypernym	धाव_पट्टी
क़ैफ़ी	_hypernym	ध्रुवीय
सन्नद्ध	_onto_nodes	संगीतात्मक
त्रयोदशी_तिथि	_onto_nodes	लेज़िम_नृत्य
कनेरी	_onto_nodes	कंधे_पर_आना
कढ़ीचट	_hypernym	पब्लिक_प्रॉसिक्यूटर
जिल_आम	_hypernym	एन्टिना
साउथ_अफ्रीका	_onto_nodes	फिल्टर_कॉफी
अन्धिका	_onto_nodes	भुँइफोर
लज्जाप्रद	_onto_nodes	व्यास
अंगूठाछाप	_onto_nodes	निकुरम्ब
फूफा	_onto_nodes	बांदीपुरा
येडो	_onto_nodes	दक्षिणावर्त
शासनतन्त्र	_onto_nodes	भुँइफोर
मुस्तफा_खाँ	_onto_nodes	पदासन
झूलनापुल	_onto_nodes	मुखशोधन
मानस	_hypernym	बेठन
मांड़ी	_onto_nodes	अनतुला
मंगरौल	_onto_nodes	संगीतात्मक
शैनेय	_onto_nodes	सृंजय
संयमशील	_hypernym	हिल्सिंगफोर्स
रेशमी_कीट	_onto_nodes	सीकर
महानारायण_उपनिषद्	_onto_nodes	अवाकी
चौपट_करना	_onto_nodes	व्यास
गोथ	_onto_nodes	सत्यसन्ध
खोन्सा	_onto_nodes	बांदीपुरा
घृताची	_hypernym	कमोबेश
इच्छा_शक्ति	_onto_nodes	अमानुष
वर्म	_onto_nodes	संगीतात्मक
मद्देनज़र	_onto_nodes	भुँइफोर
कहलाना	_onto_nodes	चंद्राकार
सूपी	_hypernym	रेहुआ
सुमसुखड़ा	_hypernym	आयोधन
अफरीका-संबंधी	_onto_nodes	चालचलन
फैलवाना	_hypernym	निःशुल्क
फँसा	_onto_nodes	प्रतिधावन
तीक्ष्णाग्र	_onto_nodes	कंधे_पर_आना
भस्म	_hypernym	ताल-मेल
दिफू_शहर	_hypernym	ह्वेल
गुहिका	_onto_nodes	व्यास
ढोंग	_onto_nodes	सीकर
कुंडलीकृत	_onto_nodes	लेज़िम_नृत्य
वर्ल्ड_वार_I	_hypernym	श्वेतकांडा
अक्लमंद	_onto_nodes	अनिष्टकर
सुधांशु	_onto_nodes	बहवाना
मधुमात	_hypernym	एड्रिएटिक_सागर
बेनंग	_onto_nodes	पैरदान
परिसंवाद	_hypernym	अबीरा
मूली_नदी	_hypernym	सिंधुजा
घरेलू_खर्चा	_onto_nodes	छलशून्यता
हेटी_देश	_onto_nodes	साया
गडेरिया	_hypernym	अग्निमंथ
ख़बरदार_करना	_onto_nodes	साया
जनित	_hypernym	क़ाटर-वासी
असंबंधित	_hypernym	टूट_पड़ना
शुक्रग़ुज़ार	_onto_nodes	छलशून्यता
यक्षिणी	_hypernym	विस्मित_होना
बधाई	_onto_nodes	सीकर
ज़ंजीर_कवच	_onto_nodes	इतेक
हिन्डोला	_onto_nodes	चंद्राकार
आकबतअंदेशी	_onto_nodes	भुँइफोर
रक्तशीषक	_onto_nodes	भुँइफोर
खरीददारी	_onto_nodes	देशभक्त
चंदक	_onto_nodes	सीकर
हेम	_hypernym	अभिस्यन्दी
आँख-मिचौनी	_hypernym	उनतालीस
आरंभ_करना	_onto_nodes	आँख_मूँदकर
ईंटाया	_onto_nodes	नन्दा
रघुबर	_onto_nodes	सृंजय
सुख-सम्पत्ति	_onto_nodes	साया
टेलीस्कोप	_onto_nodes	संगीतात्मक
लक्ष्मणकंद	_onto_nodes	मान्यताप्राप्त
रुंज	_hypernym	एकारादि
असंग	_onto_nodes	सृंजय
विहंगीय	_hypernym	सम्भागीय
_ब्रूने_रिन्गिट	_onto_nodes	साया
जलमग्न	_hypernym	तापसी
उपभोग	_hypernym	वुली_बन्दर
गैर_हाजिरी	_onto_nodes	भुँइफोर
इंद्रधनुषीय	_onto_nodes	खपाची
निपटाव	_entailment	लक्षपति
बुलौवा	_onto_nodes	भुँइफोर
नाड़ी	_hypernym	प्रतिलेखक
सेन्ट्रल_अफ्रीकन_रिपब्लिक	_hypernym	इकलाई
मालकोष	_hypernym	मनोविज्ञानिक
वर्णिकछन्द	_hypernym	तुरुप
ज़मानती	_hypernym	पसीने_से_तर
धीन	_onto_nodes	ईयर
आत्म_चरित्र	_onto_nodes	सृंजय
दौड़_लगाना	_onto_nodes	पिछलगा
बदसूरत_बुढ़िया	_hypernym	एकांतरहित
मरणासन्न_होना	_hypernym	यमनी_रीयाल
प्रपौण्डरीक	_onto_nodes	सृंजय
शुभ	_hypernym	पत्तर
तापसी	_hypernym	नतिनी
अमानत-नामा	_hypernym	यशी
फिट_होना	_hypernym	श्वेतकांडा
गुर्जर	_onto_nodes	सत्यसन्ध
चिड़ियाघर	_onto_nodes	खपाची
इकतालीसवाँ	_onto_nodes	सीकर
अँतरा	_hypernym	ठाणा_जिला
मत्त_होना	_hypernym	टेलिफ़ोन
57वाँ	_hypernym	जजु
गैलड़	_hypernym	सृंजय
गला_रोग	_onto_nodes	सत्यसन्ध
रिज़र्व	_hypernym	कलपेट्टा
दक्षिणी-अमेरिका_वासी	_onto_nodes	सफदर_पसंद_आम
उपभोक्ता_वस्तु	_hypernym	लहर
अवरोहित	_hypernym	अवलुंचित
वटपूर्णिमा	_onto_nodes	ज्येष्ठत्व
सलिलज	_hypernym	वराहिका
फाहियान	_onto_nodes	अनद्यतन
गेंदा	_onto_nodes	भुँइफोर
दुड़ियंद	_onto_nodes	जीर्ण-शीर्ण
ब्योरेवार	_onto_nodes	अमानुष
बंगला_लिपि	_hypernym	कोरी
पश्चिम_मिदनापोर_ज़िला	_onto_nodes	शीघ्र
सूरीनाम_गणतन्त्र	_hypernym	अभिज्ञान
काफी_घर	_hypernym	सिंधुजा
अनप	_hypernym	कारक_घटक
अज्ञातराशि	_onto_nodes	फिल्टर_कॉफी
मलेरिया	_hypernym	सिंदूरपुष्पी
त्रैबलि_ऋषि	_onto_nodes	सीकर
अनजाना	_onto_nodes	छलशून्यता
शतपथी	_hypernym	गोचरपिण्ड
शंकुचि_मछली	_hypernym	भतीजी
टेलीविज़न_सिस्टम	_onto_nodes	बहवाना
पूछपाछ	_hypernym	दक्षिण_अमेरिकी_देश
प्रसारित	_onto_nodes	मेक्सिको
आघात_वर्धनीय	_hypernym	सप्तक
टॉयलेट	_hypernym	पब्लिक_प्रॉसिक्यूटर
आपदाग्रस्त	_hypernym	अर्जेन्टीना
दौड़वाना	_onto_nodes	सृंजय
साठेक	_hypernym	सलीक़ा
वृद्धदारक	_hypernym	गोचरपिण्ड
सतबहनी	_hypernym	कुवैतवासी
बेनट	_onto_nodes	ईयर
दहशतगर्द	_onto_nodes	अनतुला
टूवैलू_गणराज्य	_onto_nodes	प्रतिधावन
गौरीशंकर_चोटी	_onto_nodes	तुरंगिका
सौंपना	_onto_nodes	जीर्ण-शीर्ण
कंप्यूटर_मेमोरी	_onto_nodes	चोरबदन
अरुंधति	_onto_nodes	सृंजय
फेनमेह	_onto_nodes	भुँइफोर
सांविधिक	_onto_nodes	बहवाना
पालनपुर	_onto_nodes	मुखशोधन
औरया	_onto_nodes	खपाची
इलेक्ट्रॉनिकी	_hypernym	कुवैतवासी
बन्धु	_hypernym	बिलल्ला
पुलवामा_ज़िला	_hypernym	अभिव्यक्तिशील
धौलधप्पा	_hypernym	आटोमोबील
मेघज्योति	_onto_nodes	साया
कलारपारा	_onto_nodes	सीकर
मगही	_onto_nodes	नवधा-भक्ति
सिंधुराज	_onto_nodes	दक्षिणावर्त
वातचटक	_hypernym	टेलिफून
स्वर्णचूड़	_onto_nodes	मोतियदाम
हरीश	_onto_nodes	व्यास
भोगविलास	_hypernym	तन्ख्वाह
मलमूत्र	_hypernym	बनड़ाजैत
औषध_विज्ञान	_onto_nodes	बहवाना
उछाल	_onto_nodes	भुँइफोर
लथ-पथ	_hypernym	सेवक_वर्ग
हेमकण	_hypernym	श्वेतकांडा
खाँ	_onto_nodes	आईआईटी
सल्फर	_hypernym	हिमवर्षा
पञ्चकुला_ज़िला	_hypernym	लगलग
आधा_सम्मत	_hypernym	रेडियोथेरेपी
कला_रसिक	_onto_nodes	सृंजय
गजदन्ती	_hypernym	जलन्धर
ग्रोनलैण्डी-भाषा	_hypernym	निरालंब
फुफकारना	_onto_nodes	रङ्गमहल
कुमैड़िया	_hypernym	पेशवराना
झल्ल	_onto_nodes	छलशून्यता
ख़ुश_करना	_onto_nodes	ज्येष्ठत्व
दरवाजा	_onto_nodes	खपाची
पृथुदर्शी	_onto_nodes	तुरंगिका
थोकदारी	_hypernym	उनतालीस
काफी	_hypernym	क्वाँचर
वैनतेय	_hypernym	भीमकुण्ड
खतम_करना	_onto_nodes	खपाची
इज़ाफ़ा_होना	_onto_nodes	तुरंगिका
आँसूरहित	_hypernym	पाककर्म
अगुणी	_onto_nodes	भुँइफोर
रक्ष्यमाण	_onto_nodes	मेक्सिको
रोही	_onto_nodes	सीकर
मनोरंजनगाह	_attributes	पुदीना
भृम्यश्व	_onto_nodes	सीकर
गोंड_राग	_hypernym	उन्नीसवीं
पँवारना	_onto_nodes	सृंजय
प्रशंसा	_onto_nodes	बहवाना
ध्वंसावशेष	_onto_nodes	सत्यसन्ध
सौर्य	_hypernym	बिलल्ला
घोषित	_onto_nodes	संगीतात्मक
हिडिम्बा	_hypernym	नन्दलाल
अर्थ_होना	_onto_nodes	अवाकी
शरावरण	_onto_nodes	तुरंगिका
सजा	_onto_nodes	ईयर
चिड़	_hypernym	रेहुआ
मलिनता	_onto_nodes	व्यास
विभांडक_ऋषि	_onto_nodes	रङ्गमहल
शायरी	_onto_nodes	शीघ्र
शहडोल_शहर	_onto_nodes	संगीतात्मक
अंधियार_कोठरी	_onto_nodes	बहवाना
रिरिहा	_onto_nodes	छलशून्यता
धोखेबाजी	_hypernym	अवतारण
मधूकपर्णा	_onto_nodes	इतेक
अहिछत्र	_hypernym	उनतालीस
नाबालिग़ता	_onto_nodes	साया
दर्रांग	_onto_nodes	अवाकी
लेप_लगना	_hypernym	स्टील_अथॉरिटी_ऑफ_इंडिया_लिमिटेड
निरप्र	_hypernym	क्षीणक-रोग
मज़बूरी	_onto_nodes	फिल्टर_कॉफी
चिकित्सा_विज्ञानी	_onto_nodes	भुँइफोर
नागद्रुम	_onto_nodes	भुँइफोर
टोक्यो	_hypernym	वल्वग
अविकट	_hypernym	भू-रचना
सट्टा	_onto_nodes	भुँइफोर
सिंधुविष	_onto_nodes	गड़गड़ा
टिगुसिगाल्पा	_hypernym	हवि
दक्षिणपंथ	_onto_nodes	संगीतात्मक
टौन्स_नदी	_onto_nodes	साया
मालडोवा_गणराज्य	_hypernym	फक्कड़ाना
फ़ुलपैंट	_onto_nodes	साया
योरोप	_onto_nodes	रङ्गमहल
शकुंद	_onto_nodes	साया
वापस_करना	_onto_nodes	अवात
हुकना	_hypernym	महा_ज्ञानी
गौटेमाला_वासी	_hypernym	परलोक_सिधारना
खुल्लम_खुल्ला	_hypernym	स्क्रीन_प्रिंट
चुनचुनाना	_onto_nodes	90वाँ
अननुज्ञा	_hypernym	मतलब_होना
लहराता	_onto_nodes	सीकर
पंककीर	_onto_nodes	वराहक्रान्ता
शुद्धिकंद	_onto_nodes	ख़रीता
जूजू	_onto_nodes	न्यूज़_पेपर
जरकस	_onto_nodes	साया
साइंटिस्ट	_hypernym	ठाणा_जिला
प्यूस	_onto_nodes	संगीतात्मक
ऊर्ध्व_मुख	_onto_nodes	भुँइफोर
पैशाचिक	_onto_nodes	सृंजय
नखरा	_hypernym	उनतालीस
अल्ज़ाइमर_रोग	_hypernym	नवनीतम
वर्जिन_मेरी	_hypernym	सिंधुजा
रदनच्छद	_hypernym	बड़वा_दीप्ति
वर्जनीय	_hypernym	कैनसिल
उलटपुलट	_onto_nodes	सीकर
मधुसंभव	_onto_nodes	रङ्गमहल
दक्षिणावर्त_शंख	_onto_nodes	रङ्गमहल
पाणि_मूल	_hypernym	उनतालीस
कंकत्रोट	_onto_nodes	अनिष्टकर
ऐश्वर्यदायी	_hypernym	गोचरपिण्ड
संज्ञायुक्त	_onto_nodes	भुँइफोर
शिशुता	_hypernym	जुर्म
ग्रामीण_विकास_मन्त्रालय	_onto_nodes	भुँइफोर
ख्याति	_onto_nodes	न्यूज़_पेपर
गृहप	_onto_nodes	भुँइफोर
आच्छादित	_onto_nodes	पूर्णचाँद
शीतलाष्ठी	_onto_nodes	बांदीपुरा
सत्ता_हस्तांतरण	_onto_nodes	अपरुष
प्रतिपादन	_onto_nodes	सृंजय
संभार	_onto_nodes	मेक्सिको
लिवाल	_onto_nodes	मोतियदाम
दंत_चिकित्सक	_onto_nodes	ज्येष्ठत्व
सेंसेक्स	_hypernym	उनतालीस
अध्यायी	_onto_nodes	छलशून्यता
ढलकवाना	_onto_nodes	भुँइफोर
हिन्डोला	_hypernym	तब_भी
अभ्यागम	_onto_nodes	भुँइफोर
मीरहाज़	_onto_nodes	मित्रवती
पोस्ट-ग्रेजुएट	_onto_nodes	अमानुष
अन्तर्धी	_onto_nodes	ज्येष्ठत्व
तड़क	_hypernym	निरालंब
उदराशय	_hypernym	शतपथी
तांडव_नृत्य	_hypernym	बिलल्ला
स्वाधीनतः	_hypernym	घटता
भाषक	_hypernym	गोचरपिण्ड
बुज़दिल_व्यक्ति	_onto_nodes	दक्षिण_२४_परगना_जिला
विधिविरुद्धता	_hypernym	वर्णार्ह
शकरखोरा	_hypernym	जलीय-जंतु
छमाही	_onto_nodes	बिलल्ला
केप_वर्ड	_hypernym	कोरी
स्यंदन	_onto_nodes	छलशून्यता
लेडी_डाक्टर	_hypernym	जनमानस
अथर्व-शिर_उपनिषद्	_onto_nodes	आँख_मूँदकर
ग्रहपीड़ा	_hypernym	उत्तुंग
बोल्ड_होना	_hypernym	भोजपुर_ज़िला
पुसाना	_onto_nodes	संगीतात्मक
नोधा_ऋषि	_hypernym	टेलिफून
डक्स_एग	_onto_nodes	रङ्गमहल
चौबीसवाँ	_onto_nodes	भुँइफोर
अरकनाना	_hypernym	टेलिफून
दैवीय_नियम	_hypernym	पब्लिक_प्रॉसिक्यूटर
झनस	_hypernym	झाँई
उतथ्य_ऋषि	_hypernym	कोरी
ईदुलज़ुहा	_hypernym	पब्लिक_प्रॉसिक्यूटर
पाकड़	_onto_nodes	जान_जाना
वेरक	_hypernym	बुदबुदा
लोक-धुन	_onto_nodes	रङ्गमहल
समय	_hypernym	अनंतराशि
शब्दार्थ	_onto_nodes	बहवाना
अपतित	_hypernym	रणभूमि
उच्चार	_hypernym	कुमुदिनी
सोनपुर_ज़िला	_hypernym	वर्जनीय
दुर्गंध_देना	_onto_nodes	संगीतात्मक
खेती_बाड़ी	_hypernym	नरपति
अज्ञानी	_onto_nodes	जीर्ण-शीर्ण
आलोचन	_hypernym	नरपति
हत्फ-8_क्रूज_प्रक्षेपास्त्र	_onto_nodes	संगीतात्मक
बरसी	_hypernym	हवि
लुजा	_onto_nodes	खपाची
त्रिचूर_पूरम	_onto_nodes	अमानुष
अंतःशल्य	_onto_nodes	प्रतिधावन
कंवासी	_hypernym	गोचरपिण्ड
पचपकवानी	_onto_nodes	अरदल
शीत_लहर	_onto_nodes	ज्येष्ठत्व
दुन्दुभ	_onto_nodes	साया
परमेष्ठ	_hypernym	द्विदल
वृहच्छद	_onto_nodes	अमानुष
समा_बंधना	_onto_nodes	मुखशोधन
खरीद	_onto_nodes	ज्येष्ठत्व
राज्यमंत्री	_hypernym	बुज़दिल_व्यक्ति
त्रिबाहु	_onto_nodes	सीकर
उलान_बटोर	_onto_nodes	चालचलन
कालनेमी	_hypernym	सोने_में_सुहागा_होना
भूँ_भूँ	_onto_nodes	सीकर
अर्बियम	_hypernym	स्मृति_चिह्न
सौराथी	_hypernym	उपकर्त्ता
सलवार_कमीज	_attributes	फुनगा
अरजल	_onto_nodes	चैम्पियनशिप
सराइकेला_खरसावाँ_जिला	_onto_nodes	बांदीपुरा
चित्रयवनिका	_onto_nodes	इतेक
कामदा_एकादशी	_onto_nodes	खपाची
किल्ली	_onto_nodes	सीकर
रिजका	_hypernym	धाव_पट्टी
बुज़दिल	_hypernym	वाह्लीक_घोड़ा
सेफ़्टी_पिन	_hypernym	झांकी
ईशावास्य_उपनिषद्	_hypernym	पर्शिआ
जुगजुगाना	_hypernym	पोषकत्व
अंतस्	_onto_nodes	सीकर
दतलेखन	_onto_nodes	बहवाना
वेस्ट	_hypernym	उनतालीस
हैहयाधिराज	_onto_nodes	अमानुष
आत्मसंयम	_onto_nodes	सीकर
उर्मिला	_hypernym	धूल_चटाना
गौतमबुद्ध_नगर_ज़िला	_onto_nodes	सृंजय
पपीता	_onto_nodes	अमानुष
चांदतारा	_onto_nodes	अवाकी
गोआ-अल्फॉन्सो_आम	_hypernym	बिलल्ला
दुरुस्त	_onto_nodes	सीकर
इंद्रधनुषीय	_onto_nodes	संगीतात्मक
अर्जेंटिना_गणतंत्र	_onto_nodes	ग्रोस
स्लेज	_hypernym	अट्टी
उत्तर_पत्र	_onto_nodes	इतेक
जन_गणना	_hypernym	धाव_पट्टी
गोल्फर	_hypernym	ताल-मेल
लिमिटेड	_onto_nodes	व्यास
मटीरियल	_hypernym	जरकसी
अंधोटी	_onto_nodes	हिलवाना-डोलवाना
बत्तीसवाँ	_hypernym	पब्लिक_प्रॉसिक्यूटर
वेल्लूर_ज़िला	_hypernym	रेकॉर्ड_किया
पुरुषीय	_hypernym	धाव_पट्टी
सेंधा	_onto_nodes	सीकर
अटकन-बटकन	_onto_nodes	सृंजय
बहुभाषिक	_hypernym	दीन-पालक
मरीगांव_शहर	_onto_nodes	व्यास
स्थलाकृति	_hypernym	हरफ़न_मौला
शिविर_स्थल	_hypernym	ध्यानबिंदु
परस	_hypernym	नम्य_बनाना
सही_सलामत	_onto_nodes	इतेक
अर्धुक	_onto_nodes	सीकर
सुदिन	_onto_nodes	ज्येष्ठत्व
शब्दग्रह	_hypernym	गिट्टक
दत्तात्रेयोपनिषद्	_onto_nodes	खपाची
सप्तक	_attributes	ज्वाइंट_वेंचर
निश्छलता	_onto_nodes	भुँइफोर
सम्भ्रांत	_onto_nodes	सीकर
दमनशील	_attributes	परजा
मटीरियल	_onto_nodes	नवधा-भक्ति
नरगिस	_onto_nodes	भुँइफोर
रायसेन_शहर	_hypernym	सर्वेश्वर
मदनवृक्ष	_onto_nodes	खपाची
शाहजहानपुर_शहर	_hypernym	पब्लिक_प्रॉसिक्यूटर
सार्वजनिक_परिवहन	_onto_nodes	भुँइफोर
फ़िजूल	_onto_nodes	चंद्राकार
उत्तरअमरीकी_राष्ट्र	_onto_nodes	सीकर
एकाण्डी_यमज	_hypernym	मादा_कोश
पारसी_देवता	_hypernym	सृंजय
डबल	_hypernym	ज़िबरा
पनडुबी	_hypernym	बनवारी
केश_समूह	_onto_nodes	साया
अवसादहीन	_hypernym	ढंग
सहडोल_ज़िला	_onto_nodes	ईयर
हाथ_लगना	_onto_nodes	सत्यसन्ध
वैशाखी	_hypernym	अभिप्रणय
प्रिमिटिव	_onto_nodes	भुँइफोर
इसीलिए	_onto_nodes	खपाची
श्रीवासक	_onto_nodes	बहवाना
लैम्प-पोस्ट	_onto_nodes	पैरदान
आत्म-चरित्र	_onto_nodes	भुँइफोर
मालटा	_onto_nodes	पिछलगा
डोका	_hypernym	प्रथी
मानसरोवर	_onto_nodes	भुँइफोर
मूषिकपर्णी	_onto_nodes	रङ्गमहल
ओल्हापाती	_onto_nodes	रङ्गमहल
वासुकि	_hypernym	बिलल्ला
वर्त्तरुक	_hypernym	समंतदुग्धा
तुकबंदी_करना	_onto_nodes	भुँइफोर
अपराधशील	_onto_nodes	ज्येष्ठत्व
गुड़गुड़ी	_hypernym	धाव_पट्टी
पहले_का	_hypernym	गुड़ाई-निराई
पाखण्ड	_onto_nodes	चंद्राकार
सिंध_नद	_hypernym	अनायत
गोचरता	_onto_nodes	न्यूज़_पेपर
पिछला_भाग	_hypernym	ब्रह्मरेख
अविनीता	_onto_nodes	सृंजय
नजारा	_onto_nodes	पूर्णचाँद
टेढ़ा_करना	_hypernym	नष्ट_होना
श्लीपदी	_onto_nodes	भुँइफोर
कूकरखाँसी	_onto_nodes	प्रतिधावन
जवा-पुष्प	_hypernym	रंगहीन
कड़ाक	_onto_nodes	जीर्ण-शीर्ण
समधिन	_hypernym	बिलल्ला
दक्षिणी_सिक्किम	_onto_nodes	मेक्सिको
तुम्बुरी	_hypernym	गोचरपिण्ड
उत्कीर्ण_लेख	_hypernym	पितिया_ससुर
पश्चिम_चम्पारण_जिला	_onto_nodes	जीर्ण-शीर्ण
मह	_hypernym	मालतीजात
बस_स्टाप	_hypernym	मड़ुवा
अलास	_hypernym	ठाणा_जिला
बिड़िक	_hypernym	कन्डोम
शुण्डाल	_hypernym	निरालंब
शतरंज	_hypernym	अकड़बाज
प्रशंसी	_hypernym	पब्लिक_प्रॉसिक्यूटर
वेंटिलैटर	_hypernym	रेहुआ
आयरिश_भाषा	_hypernym	खूसट
असन्तत	_onto_nodes	बिलल्ला
मूत्रिका	_onto_nodes	रङ्गमहल
कुबेर	_onto_nodes	सृंजय
बेलरस	_hypernym	महाराणा_कुम्भकर्ण
ट्रैफिक	_hypernym	वर्धक
उच्च_वर्ग	_hypernym	प्रक्षेपास्त्र
रघुवंशतिलक	_hypernym	दक्षिणायण
रईसी	_onto_nodes	ईयर
तैंतीस	_onto_nodes	दक्षिण_२४_परगना_जिला
विवर्त	_onto_nodes	संगीतात्मक
उद्दंड_बनना	_hypernym	इंचना
की-बोर्ड	_onto_nodes	गड़गड़ा
अपकृत्	_hypernym	नम्य_बनाना
लिखित	_hypernym	स्मृति_चिह्न
दीवान-ए-खास	_onto_nodes	व्यास
जल-क्रीड़ा_करना	_onto_nodes	साया
अनुचित	_hypernym	प्रसूति_काल
क़ाबू_पाना	_onto_nodes	बिलल्ला
काला_पपीहा	_onto_nodes	सत्यसन्ध
चौथाई_भाग	_onto_nodes	सीकर
सतबहनी	_onto_nodes	अनिष्टकर
शांतिप्रिय	_hypernym	भट्टी
नख़रेबाज़ी	_hypernym	कोरी
पंडित	_onto_nodes	मेक्सिको
भिड़	_hypernym	गोचरपिण्ड
अर्जेंटीना	_hypernym	पब्लिक_प्रॉसिक्यूटर
असंवैधानिक	_onto_nodes	छलशून्यता
प्राणी_जगत	_onto_nodes	अवाकी
दफ	_onto_nodes	वराहक्रान्ता
ललमुनिया	_onto_nodes	बाणगङ्गा_नदी
अंतर्राष्ट्रीय_परमाणु_ऊर्जा_एजेंसी	_onto_nodes	खपाची
भिटौरी	_onto_nodes	चोरबदन
अंठानबेवाँ	_hypernym	गोचरपिण्ड
डेटोनेटर	_onto_nodes	अवाकी
मणिबंध	_hypernym	गिब्बन_वानर
मेम	_onto_nodes	सीकर
गुड़ाम	_hypernym	अभिरना
फलविहीन	_onto_nodes	संगीतात्मक
गौड़	_onto_nodes	मुखशोधन
रारी	_entailment	अवलुंचित
मन्त्रीपरिषद	_hypernym	केप_वर्ड
पाचि	_onto_nodes	भुँइफोर
सामन्तीय	_hypernym	उनतालीस
अनंतराशि	_onto_nodes	पूर्णचाँद
अवमानित	_hypernym	सदारत
ढलाव	_hypernym	फलवान
कुचियादाँत	_hypernym	कीटनाशक
कोचरा	_onto_nodes	अरसाना
खङग	_onto_nodes	अतरवन
साइमीस	_onto_nodes	बहवाना
देवनिंदक	_hypernym	हेमपुष्पी
यूनेस्को	_hypernym	गोचरपिण्ड
काश्तकारी	_hypernym	सिंधुजा
रॉम	_onto_nodes	सीकर
छिंदवाड़ा_ज़िला	_hypernym	छक्का-पंजा
सर्दी	_hypernym	सिंधुजा
दहेज़_प्रथा	_hypernym	क्षीणक-रोग
अविवादास्पद	_hypernym	श्वेतकांडा
टुक-टुक	_hypernym	धाव_पट्टी
कामयाब	_hypernym	रेहुआ
तीखा	_onto_nodes	न्यूज़_पेपर
टाटानगर	_onto_nodes	व्यास
पञ्चकुला_ज़िला	_onto_nodes	व्यास
हरिश्चंद्र	_onto_nodes	शीघ्र
इसागढ़	_onto_nodes	रंगरेज
संजीवनी	_hypernym	अभिरना
वराहिका	_onto_nodes	पूर्णचाँद
आत्मदर्शी	_hypernym	नाज़ुक_बाल
युग्मकी_कोशिका	_onto_nodes	ईयर
उत्पादन_करना	_hypernym	रणभूमि
असही	_onto_nodes	संगीतात्मक
दफा	_onto_nodes	भुँइफोर
भू-सीमा	_hypernym	लिट्टा
श्वेतधामा	_onto_nodes	सूपाबेना
चैत्रगौड़ी	_onto_nodes	संगीतात्मक
चुस्की_लेना	_onto_nodes	साया
में-में	_hypernym	वराहकान्ता
तक्षकला	_hypernym	मन_लगाना
अश्रद्धेय	_hypernym	नाज़ुक_बाल
अलग	_hypernym	जलरंड
पार्किंसनिज़्म	_hypernym	गोचरपिण्ड
ऐथलीट	_hypernym	चूँ_चाँ
वॉशिंगटन_डी_सी	_hypernym	लाक्षणिक
स्वयंभुव_मनु	_onto_nodes	संगीतात्मक
घटाटोप	_hypernym	उड्डयन_मन्त्री
रसोद्भूत	_onto_nodes	व्यास
बजाजा	_onto_nodes	पूर्णचाँद
नींबू-पानी	_onto_nodes	सृंजय
तेग	_onto_nodes	बाणगङ्गा_नदी
कंडोम	_onto_nodes	चालचलन
बकुल	_onto_nodes	अमानुष
गौनहारी	_onto_nodes	ज्येष्ठत्व
गोरा_पत्थर	_onto_nodes	साया
विनाश_काल	_hypernym	सूथन
विषम	_hypernym	उल्टा_पैदा
स्लोवाकिया	_onto_nodes	संगीतात्मक
यंत्र-भाग	_hypernym	इतिवृत्त
गुड़गोबर	_onto_nodes	संगीतात्मक
चूना-पत्थर	_hypernym	कुसुमाधिप
झंझटी	_hypernym	अर्धसहमत
सुहोत्र_दैत्य	_onto_nodes	रखैया
कुल्लू	_onto_nodes	सत्यसन्ध
अरसठ	_hypernym	कोरी
धुंधुमार	_onto_nodes	खपाची
मेरुरज्जु	_hypernym	पाककर्म
माजून	_hypernym	किलाबन्दी
अंक-फलक	_hypernym	पुष्पसार
सुदूरवर्ती	_onto_nodes	सत्यसन्ध
अवराधन	_hypernym	समुद्री_डकैती
कुलमिलाकर	_onto_nodes	रङ्गमहल
देहरादून	_onto_nodes	पिछलगा
बलांगिर_शहर	_onto_nodes	पैरदान
रिपोर्ट_करना	_onto_nodes	सत्यसन्ध
बौद्ध_मठ	_hypernym	शिक्षण-कला
उपदेश	_hypernym	सहलाई
पोचा	_onto_nodes	भुँइफोर
रूखापन	_onto_nodes	भुँइफोर
तवक्षीर	_onto_nodes	खपाची
हास्य_कथा	_onto_nodes	अनिष्टकर
वृत्तपुष्प	_onto_nodes	अवाकी
चुराचाँदपुर_शहर	_onto_nodes	छलशून्यता
उत्कर्ष-अपकर्ष	_onto_nodes	सृंजय
पाटस_बंदर	_onto_nodes	सृंजय
रक्त-पुष्पिका	_onto_nodes	अवाकी
चिढ़ानेवाला	_hypernym	ठाणा_जिला
अक्रमतः	_hypernym	पर्वत_शृंग
उत्तरकाशी_ज़िला	_hypernym	सह_संक्रमण
भेद	_hypernym	ताल-मेल
पक्षरहित	_hypernym	अभिरना
माप-तौल	_hypernym	अभिरना
लालमी	_onto_nodes	ईयर
पूर्णमासी	_onto_nodes	उल्टा_सीधा
गीतकाव्य	_hypernym	धाव_पट्टी
चेतनारहित	_onto_nodes	अनिष्टकर
विरोचन	_hypernym	गुल्मरोग
शंपा	_onto_nodes	माफी_देना
अत्यय	_onto_nodes	संगीतात्मक
मिचलाहट	_hypernym	नकल_उतारना
कल्पनाकर्ता	_hypernym	इंडियन_नैशनल_लोकदल
बैरिअर	_onto_nodes	सत्यसन्ध
पाकिस्तानी_रुपया	_onto_nodes	तुरंगिका
शरीरांत	_onto_nodes	खपाची
साक्षात	_hypernym	अबीरा
वैरिन	_onto_nodes	खपाची
असाक्षी	_hypernym	बिलल्ला
पाखरी	_onto_nodes	ज्येष्ठत्व
सुविख्यात	_hypernym	लाल_साग
काड़ी	_onto_nodes	खपाची
तबलची	_hypernym	ठाणा_जिला
आँकू	_onto_nodes	संगीतात्मक
थायरॉयड_हॉर्मोन	_onto_nodes	भुँइफोर
पूर्ण_ग्रास	_hypernym	अभिरना
वरतंतु	_onto_nodes	भुँइफोर
अभिवाद्य	_onto_nodes	व्यास
जरासन्ध	_onto_nodes	इतेक
अनियमित	_onto_nodes	भुँइफोर
समानार्थक	_hypernym	शतपथी
प्रकंपन	_attributes	वशिष्ठ
पैराशूट	_hypernym	टेलिफून
शवपरीक्षा	_onto_nodes	इतेक
ज़ायकेदार	_hypernym	निर्जना
शंखकार	_onto_nodes	खपाची
इंद्रगिरि	_onto_nodes	खपाची
फीस_माफी	_hypernym	गिट्टक
अतृप्ति	_hypernym	बंबई_आम
प्रोपेगंडा	_hypernym	स्तनहार
तूतूकुड़ी	_onto_nodes	सत्यसन्ध
मत्तमातंग-लीलाकार	_onto_nodes	चोरबदन
इन्फ़्लूएंज़ा	_onto_nodes	बहवाना
कर्मकाण्ड	_onto_nodes	पूर्णचाँद
मूर्ख_व्यक्ति	_hypernym	सह_संक्रमण
अभिगम	_hypernym	सप्तक
अचाहा	_onto_nodes	अरदल
वरित	_onto_nodes	परियोजना
आंकड़े	_onto_nodes	भुँइफोर
वैष्णवी	_onto_nodes	अन्न_ग्रहण
पुलिरिक	_onto_nodes	खपाची
वर्णिक_छन्द	_onto_nodes	सृंजय
एँच_पेंच	_hypernym	लिझड़ी
बधाई_गीत	_onto_nodes	वराहक्रान्ता
पेश_आना	_onto_nodes	रखैया
अमराई	_hypernym	मित्रवती
सिन्धुसुत	_onto_nodes	पदासन
माँजना	_hypernym	उपजनजाति
व्याज	_hypernym	कैन
यूपीए	_hypernym	रणभूमि
बिहिश्त	_onto_nodes	सत्यसन्ध
अभिमान_से	_hypernym	सहलाई
टेबलेट	_onto_nodes	संगीतात्मक
अपेक्षिता	_onto_nodes	सृंजय
इन्कलाबी	_onto_nodes	खपाची
चुहटनी	_onto_nodes	न्यूज़_पेपर
जुगुप्सा	_onto_nodes	भुँइफोर
धरमपत्नी	_hypernym	अभिरना
अखड़ैत	_hypernym	लीबियन_दिरेम
विश्रान्ति	_hypernym	ताल-मेल
अंतर्दिशा	_onto_nodes	ज्येष्ठत्व
मण्डला_ज़िला	_onto_nodes	अमानुष
रायचूड़_जिला	_hypernym	जलरंड
व्रतगामी	_onto_nodes	चंद्राकार
जमानासाज	_onto_nodes	रङ्गमहल
रमणीयता	_onto_nodes	भुँइफोर
ढुलना	_hypernym	पब्लिक_प्रॉसिक्यूटर
दिनकर	_onto_nodes	सीकर
कखौरी	_onto_nodes	सृंजय
मान्यताप्राप्त	_onto_nodes	संगीतात्मक
बेगड़ी	_onto_nodes	साया
रासायनिक_द्रव्य	_hypernym	सम्भागीय
क्रुज़ेरिओ	_hypernym	दफा
राम-बाण	_onto_nodes	साया
आत्मदानी	_onto_nodes	सीकर
स्वर्णजीवा	_onto_nodes	आईआईटी
मँजा	_hypernym	नरपति
टेण्डन	_hypernym	अप्रियभाषी
घनगर्जना	_hypernym	पुदुच्चेरी_ज़िला
दंत_चिकित्सक	_hypernym	लिलाट
बेल्जियन_कोन्गो	_onto_nodes	साया
गैर_आदमी	_hypernym	शनिदेव
सुकंदक	_onto_nodes	रङ्गमहल
जनवासा	_onto_nodes	भुँइफोर
आई_बैंक	_hypernym	सलामी_बल्लेबाज़
बेलिज़ी	_hypernym	नाज़ुक_बाल
चुटिला	_onto_nodes	भुँइफोर
विजया-सप्तमी	_hypernym	मत्ता
निश्चयात्मक	_hypernym	बधाई_कार्ड
डिब्रूगढ़_जिला	_hypernym	इमला
यशी	_hypernym	धाव_पट्टी
चटाक_से	_onto_nodes	साया
छुटना	_hypernym	अभिस्यन्दी
नक्षत्रेश	_hypernym	वायरसरोधी
बटन	_hypernym	रियाज
विष्णुक्रान्ता	_onto_nodes	45
ऐंबैसडर	_onto_nodes	रङ्गमहल
अप्रत्यय	_onto_nodes	सीकर
गृहनिर्मित	_onto_nodes	खपाची
पेयूष	_hypernym	बुदबुदा
दरपरदा	_onto_nodes	पिछलगा
गृहमोचिका	_hypernym	बिलल्ला
लोनियाँ	_hypernym	विनोवा_भावे
मेमोरी_डिवाइस	_onto_nodes	अनिष्टकर
अरयारी	_onto_nodes	ज्येष्ठत्व
शीर्णपत्र	_onto_nodes	सीरियाई_पौंड
२८	_onto_nodes	सूपाबेना
लोटा-सज्जी	_hypernym	केओनझर
ढिंढोरिया	_onto_nodes	भुँइफोर
उखर	_onto_nodes	अवाकी
कलि-संटारणोपनिषद्	_hypernym	डिल्ला
अंतरंग	_hypernym	अबन्धु
खेला_हुआ	_hypernym	नाज़ुक_बाल
ब्योरा	_hypernym	अनुभूति_होना
वनस्पति	_onto_nodes	अवाकी
निलम्बन	_onto_nodes	अवाकी
वियोग	_onto_nodes	दतौन
रुथिनियम	_hypernym	टेलीविज़न_चेनल
पैनावू	_hypernym	स्टैंप_पेपर
स्मारिका	_hypernym	प्रसिति
डॉल्फिन_मछली	_hypernym	रिवायत
भबुआ_शहर	_onto_nodes	हिलवाना-डोलवाना
विषकंद	_onto_nodes	सृंजय
पिदारा	_hypernym	रणभूमि
संकाय	_hypernym	उसी_तरह
सटना	_onto_nodes	रखैया
चित्रित	_hypernym	पत्तर
हरिगीतिका_छंद	_hypernym	पब्लिक_प्रॉसिक्यूटर
XIV	_onto_nodes	प्रतिधावन
शक्रात्मज	_hypernym	गोबरहा
शेरे_पंजाब	_hypernym	सुदेष्णा
दान	_onto_nodes	बहवाना
16	_onto_nodes	सीकर
गोफना	_onto_nodes	रङ्गमहल
विस्तीर्ण	_hypernym	नरपति
रशियन_रूबल	_hypernym	सबल
जातीफल	_onto_nodes	संगीतात्मक
अविबुध	_onto_nodes	बहवाना
तबदीली	_hypernym	अट्टी
चामुण्डा	_onto_nodes	न्यूज़_पेपर
बालेस्वर_शहर	_onto_nodes	भुँइफोर
फ़साद	_onto_nodes	सृंजय
मीनगंधा	_hypernym	रणभूमि
फ़ील्ड	_hypernym	रियाज
छलांग	_onto_nodes	सृंजय
धान्यागार	_hypernym	मसलन
कर्ण_आवरण	_hypernym	दैववाद
नगर	_onto_nodes	सीकर
वचमूल	_hypernym	सबल
सोकरहा	_hypernym	करारना
उछालना	_onto_nodes	बिलल्ला
रुचि_देव_सावर्णि_मनु	_onto_nodes	अनिष्टकर
अपरिणीता	_hypernym	प्रसूति_काल
उत्कीर्णक	_hypernym	सह_संक्रमण
तिहद्दा	_hypernym	इष्टता
मालदह_ज़िला	_onto_nodes	बांदीपुरा
आदर_सहित	_hypernym	कमरतोड़
गंभीर_गर्त	_onto_nodes	लोक-साहित्य
अंग्रेजियत	_onto_nodes	नवधा-भक्ति
विस्मित_होना	_onto_nodes	रखैया
गणवेश	_hypernym	मंद-मंद
अरोष	_onto_nodes	45
संभाल_लेना	_hypernym	नींद_उड़ना
अचम्भा_होना	_hypernym	उसी_तरह
मनोनीत	_hypernym	पब्लिक_प्रॉसिक्यूटर
अरपनगंडा	_hypernym	ऐल्प्स_पर्वत
बुराई_करना	_hypernym	नंदिका
क्रोएशिआ	_onto_nodes	बाणगङ्गा_नदी
भारतवासी	_onto_nodes	साया
बुँदकीदार	_onto_nodes	इतेक
भुक्खड़पना	_onto_nodes	पाणिनीय
आह्लाद	_hypernym	अभिस्यन्दी
छकाछक	_hypernym	गोचरपिण्ड
मूल_नक्षत्र	_hypernym	परभणी_शहर
परचून	_onto_nodes	पूर्णचाँद
असंयम	_hypernym	उनतालीस
अविषाद	_onto_nodes	नन्दा
उद्देश्यरहित	_hypernym	पब्लिक_प्रॉसिक्यूटर
वशीभूत	_onto_nodes	सृंजय
हेतुविद्या	_hypernym	निरालंब
चंडू-खाना	_onto_nodes	ईयर
अरवल_ज़िला	_onto_nodes	खपाची
पराश्रित	_onto_nodes	बांदीपुरा
वरीधरा	_hypernym	कंठशालूक
देशव्याप	_hypernym	बर्मा_वासी
पक्का_दोस्त	_onto_nodes	साया
जड़ित	_hypernym	अतिदानी
लिखवाई	_onto_nodes	अवाकी
नालिजंघ	_onto_nodes	भुँइफोर
तपोमूर्ति	_onto_nodes	भुँइफोर
उरुग्वे	_onto_nodes	साया
दक्षिण_गोआ_ज़िला	_onto_nodes	बहवाना
रईसी	_hypernym	नाज़ुक_बाल
चिन्हाना	_hypernym	जल-स्थलचर
स्वान्तःसुखाय	_onto_nodes	बांदीपुरा
कठोरकवची_जंतु	_onto_nodes	खपाची
तोटक	_onto_nodes	शीघ्र
गंदुम	_onto_nodes	बांदीपुरा
लुकाट	_hypernym	शिल्पविद्या
छर्रा	_hypernym	सिंधुजा
अंधा_तारा	_hypernym	बिलल्ला
लकड़ी_का_कोयला	_onto_nodes	न्यूज़_पेपर
डाकुमेंटरी_फिल्म	_hypernym	मड़ुवा
ख-पुर	_onto_nodes	अतरवन
अरिष्टनेमी	_onto_nodes	अरदल
पोटा	_onto_nodes	खपाची
निढाल_होना	_onto_nodes	व्यास
नर्मी	_onto_nodes	सृंजय
सेवा_भावना	_hypernym	पब्लिक_प्रॉसिक्यूटर
पीपरामूल	_onto_nodes	सृंजय
खनिज_शास्त्र	_onto_nodes	सीरियाई_पौंड
स्कन्ध	_hypernym	बरामीटर
विधवाश्रम	_hypernym	जीव_द्रव्यक
मगरमच्छी_आँसू	_hypernym	काँकड़ासिंगी
राँकड़	_hypernym	गोचरपिण्ड
निर्वहना	_onto_nodes	सीकर
बदमिज़ाज	_onto_nodes	संगीतात्मक
खतरनाक	_hypernym	टेलिफून
म्बाबन	_hypernym	आतंकी
प्रमाणित_होना	_onto_nodes	सत्यसन्ध
उप-रत्न	_hypernym	कुमंत्रणा
प्रपौत्री	_onto_nodes	अरदल
गरूड़_गंङ्गा	_hypernym	लगलग
आज्यपा	_onto_nodes	छलशून्यता
रेपो_दर	_onto_nodes	सीकर
नीलगिरि_शहर	_onto_nodes	अनिष्टकर
कसैला	_hypernym	ताल-मेल
अकार्य	_onto_nodes	सृंजय
सुभी	_hypernym	लीलावती
तनुभव	_onto_nodes	भुँइफोर
फलहीन	_hypernym	दिवसाभिसारिका
दिनमान	_onto_nodes	बहवाना
वारली_पेंटिंग	_onto_nodes	भुँइफोर
एकाएक	_onto_nodes	ज्येष्ठत्व
वल्कलसंवीत	_onto_nodes	भुँइफोर
किरवारा	_hypernym	आरक्षित_सेना
स्विट्जरलैंड	_hypernym	अथान
दृष्टिबोध	_hypernym	पखुरा
फेडरेटेड_स्टेट_ऑफ_माइक्रोनीशिया	_hypernym	स्मृति_चिह्न
इरशाद	_hypernym	रणभूमि
कालाग्निरुद्र	_hypernym	अलबानिया_गणराज्य
राम-कली	_onto_nodes	सृंजय
अहरना	_onto_nodes	सत्यसन्ध
क़लमदान	_onto_nodes	भुँइफोर
काल्पनिक_दुनिया	_onto_nodes	ज्येष्ठत्व
छाननी	_onto_nodes	सृंजय
स्थगन	_hypernym	हक़ारत
नियम_उल्लंघन	_hypernym	फलवान
महादंत	_onto_nodes	सत्यसन्ध
भावशून्य	_hypernym	शीर्षबिन्दु
द्रव_निकास	_attributes	तोयशूका
भानुमान	_onto_nodes	अमानुष
अंतःसुख	_onto_nodes	पिछलगा
महानक	_hypernym	गोचरपिण्ड
अफ़्रीकी_देश	_onto_nodes	साया
वेरिएशन	_attributes	दुष्टचेता
दुनली	_hypernym	पुष्टता
अनुवृत्तिका	_hypernym	आशङ्कित
खेना	_onto_nodes	तुरंगिका
प्रदर्शनकर्ता	_hypernym	शालाक्य
फुआ	_hypernym	पितृ-ऋण
इस्तेदाद	_onto_nodes	मान्यताप्राप्त
कौसीद	_onto_nodes	ईयर
अम्मीं	_hypernym	सीमोल्लंघन
रूपवती	_onto_nodes	भुँइफोर
दुर्द्धर	_hypernym	रेहुआ
सरबिया	_hypernym	राहजन
आवासीय_चिकित्सक	_onto_nodes	व्यास
विदेघ	_onto_nodes	झटा_झट
दात्यूह	_onto_nodes	चोरबदन
ग्रीष्म_काल	_onto_nodes	साया
ध्यान_छूटना	_onto_nodes	सृंजय
प्रमिताक्षरा	_onto_nodes	पिछलगा
बगैर	_onto_nodes	भुँइफोर
अनुबंधी	_onto_nodes	ईयर
हमेशा_की_तरह	_onto_nodes	खपाची
मठरनी	_onto_nodes	रङ्गमहल
घमोई	_onto_nodes	रङ्गमहल
तुर्कमेनवासी	_onto_nodes	भुँइफोर
जह्नु_ऋषि	_onto_nodes	अनतुला
गोपवल्ली	_hypernym	ताल-मेल
शक्रगोप	_onto_nodes	भुँइफोर
मन्त्रणा	_onto_nodes	अमानुष
औरिया_शहर	_onto_nodes	ज्येष्ठत्व
पुलिरिक	_onto_nodes	अवाकी
अभिघार	_onto_nodes	संगीतात्मक
काकोदुंबरिका	_hypernym	पर्णकार
लक्समबोर्गी	_onto_nodes	भुँइफोर
कौड़ियाला	_onto_nodes	भुँइफोर
जीवव्य	_onto_nodes	अवाकी
वृक्षभक्षा	_hypernym	अभिस्यन्दी
हल्लागुल्ला	_onto_nodes	भुँइफोर
देवरिया_जिला	_onto_nodes	बांदीपुरा
अलाव	_onto_nodes	अविपर्यय
होल्डर	_hypernym	गोचरपिण्ड
अंबाहल्दी	_onto_nodes	चोरबदन
डॉन्ग	_onto_nodes	अनतुला
बेल्जियन_कांगो	_onto_nodes	अवाकी
नौजा	_hypernym	विभु
स्थापना	_hypernym	पब्लिक_प्रॉसिक्यूटर
हल्का	_hypernym	फलकावन
वस्त्रागार	_onto_nodes	सूपाबेना
स्टाक_एक्सचेंज	_hypernym	फलवान
चोचलेबाज़	_hypernym	उपकर्त्ता
पैतीसवाँ	_onto_nodes	शीघ्र
उग्रगंधा	_onto_nodes	अवाकी
प्राकृतिक_उत्पात	_onto_nodes	चोरबदन
त्रिशिरारि	_hypernym	बुनियादी
छापो	_onto_nodes	सीकर
गायत्री	_onto_nodes	अवाकी
द्युति_बम	_onto_nodes	सृंजय
कनफटा	_onto_nodes	विद्युज्जिह्व
मलिनमुख	_hypernym	घटता
मन्दील	_onto_nodes	आचार्य्यी
प्रवेशनीय	_hypernym	प्रसूति_काल
चुनाव	_onto_nodes	सृंजय
थाली	_onto_nodes	बाणगङ्गा_नदी
अनुशासन	_hypernym	सहलाई
बहुरंगा	_hypernym	पब्लिक_प्रॉसिक्यूटर
रीछ	_onto_nodes	बहवाना
यों	_onto_nodes	साया
अव्युत्पन्न	_onto_nodes	पूर्णचाँद
प्रफुल्लता	_onto_nodes	अंगिरस_ऋषि
कांस	_onto_nodes	भुँइफोर
आजी	_onto_nodes	भुँइफोर
मौकापरस्त	_onto_nodes	साया
असि_योद्धा	_hypernym	अभिप्रणय
बनिज	_hypernym	रक्तवर्ण
कामला	_onto_nodes	परियोजना
मेहनत	_hypernym	मथुरा_ज़िला
दखल	_hypernym	पब्लिक_प्रॉसिक्यूटर
मध्यस्थित	_hypernym	लाक्षणिक
मेसीडोनियाई-भाषा	_entailment	कार्बी_आँगलाँग_ज़िला
इलिश	_onto_nodes	ज्येष्ठत्व
पटपटाना	_hypernym	गिट्टक
अंबरीसक	_onto_nodes	शक्तिपूजन
अकारथ	_hypernym	सिंदूरपुष्पी
मयदानव	_hypernym	नाज़ुक_बाल
संपूरक	_onto_nodes	खपाची
अरुनचूड़	_hypernym	वल्वग
पूँछना	_hypernym	विश्वस्तर
लबार	_onto_nodes	सृंजय
अन्यापदेश	_hypernym	रिवायत
नरमी	_onto_nodes	पिछलगा
अहंकृति	_onto_nodes	बहवाना
सिलेण्डर	_hypernym	जीर्ण-ज्वर
फील	_onto_nodes	रङ्गमहल
अरक्षितता	_onto_nodes	साया
इकतरा	_onto_nodes	ज्येष्ठत्व
अबुध	_hypernym	शतपथी
रह_रह_कर	_onto_nodes	अवाकी
विश्वास_दिलाना	_onto_nodes	अवात
घोटना	_onto_nodes	सीकर
महल	_onto_nodes	सीकर
जीभी	_onto_nodes	मोतियदाम
पसरकटाली	_onto_nodes	सृंजय
फिनीज	_onto_nodes	साया
राकेट_संचालन_केन्द्र	_hypernym	देवजनी
दिखाई_देना	_onto_nodes	मेक्सिको
आचरण_करना	_onto_nodes	श्रीवासक
गहरी_घाटी	_onto_nodes	रङ्गमहल
रुआब	_onto_nodes	ज्येष्ठत्व
अलगरज	_hypernym	रणभूमि
सुप्रतिष्ठा	_onto_nodes	संगीतात्मक
सब्जाना	_onto_nodes	रङ्गमहल
घेराबंदी	_onto_nodes	अवाकी
झञ्झटिया	_onto_nodes	सृंजय
सरहदी	_hypernym	पुष्टता
झाड़ना	_hypernym	बाहर_आना
पत्रंग	_onto_nodes	खपाची
बैजई_रंग	_onto_nodes	रङ्गमहल
लीपा_पोती_करना	_onto_nodes	व्यास
रत्नकर	_onto_nodes	सीकर
दुर्भाग्य_से	_onto_nodes	खपाची
अस्तीन	_onto_nodes	रङ्गमहल
दिग्राज	_hypernym	शूकवती
नीलरू	_hypernym	उनतालीस
शोभाजन	_hypernym	ताल-मेल
रिसाऊ	_onto_nodes	सत्यसन्ध
रोमी	_onto_nodes	भुँइफोर
चूत	_hypernym	धाव_पट्टी
मधुबनी-चित्रकारी	_onto_nodes	सीकर
नेत्रपीड़ा	_onto_nodes	अमानुष
तश्नगी	_onto_nodes	मोतियदाम
माल_वाहक	_hypernym	सराहना
सही_चिन्ह	_onto_nodes	बहवाना
पकाई	_hypernym	भूँ_भूँ
चंद्रपुली	_hypernym	फलवान
कुचिंता	_hypernym	चींटी
अम्माजी	_onto_nodes	संगीतात्मक
घोषणा	_onto_nodes	ज्येष्ठत्व
ब्रह्म_पुराण	_hypernym	भीमकुण्ड
हकीर	_hypernym	पूर्वाह्न
पाण्ड्य	_hypernym	वुली_बन्दर
हेल-मेल	_hypernym	दरशन
समीपस्थ	_hypernym	सीमोल्लंघन
एन_एस_सी	_onto_nodes	अवाकी
अंतःस्वेद	_onto_nodes	सीकर
हस्त-उपकरण	_onto_nodes	भुँइफोर
अड़वाड़	_onto_nodes	सीकर
नवदंपति	_onto_nodes	रङ्गमहल
हवाले_करना	_onto_nodes	सीकर
मंजिका	_onto_nodes	संगीतात्मक
कोल्हू	_hypernym	चिथड़ा
समृद्धिदायी	_hypernym	ईस्टइंडीज़
नजरबट्टू	_hypernym	रणभूमि
खेती_बाड़ी	_onto_nodes	साया
गाबाई	_onto_nodes	भुँइफोर
वर्षुकांबुज	_onto_nodes	खपाची
भेंट_देना	_onto_nodes	अवाकी
कंकमुख	_onto_nodes	खपाची
कोप-भवन	_onto_nodes	अवाकी
आज_कल_करना	_onto_nodes	खपाची
तन्त्रशास्त्र	_hypernym	मांगन_शहर
रसल	_onto_nodes	भुँइफोर
देववर्द्धन	_onto_nodes	मोतियदाम
रोक	_onto_nodes	साया
मृगशाव	_onto_nodes	ज्येष्ठत्व
बंदगोभी	_hypernym	उनतालीस
सेन्सेक्स	_onto_nodes	अवाकी
पललाशय	_onto_nodes	सृंजय
मलता	_onto_nodes	सीकर
व्यंग्य_चित्र	_onto_nodes	व्यास
हिरण्यगर्भ	_onto_nodes	सूपाबेना
तिष्या	_onto_nodes	सृंजय
डार	_hypernym	गोचरपिण्ड
नवम	_hypernym	रिवायत
उपहार-गृह	_hypernym	परलोक_सिधारना
चाणक्य	_hypernym	विलावली
तिरस्कार_करना	_hypernym	गिट्टक
बगुला-भगत	_hypernym	टेलीविज़न_चेनल
एडी_करेन्ट	_hypernym	बिलल्ला
सौगंध_उठाना	_onto_nodes	भुँइफोर
उपघात	_onto_nodes	भुँइफोर
जच्चा	_hypernym	सवारी
आनन्द-सम्मोहिता	_onto_nodes	बहवाना
मंजुल	_hypernym	घबराना
ईप्सा	_attributes	10000000
ट्यूनीशिया	_hypernym	भिवानी_जिला
जबानी	_hypernym	गोह
झाल	_onto_nodes	खपाची
धातु-पुष्पिका	_onto_nodes	सृंजय
आपदा	_onto_nodes	कंधे_पर_आना
दक्षिण_सिक्किम_ज़िला	_hypernym	आपसदारी
एहसान	_hypernym	साओ_टोम_और_प्रींसिपे_जनतांत्रिक_गणराज्य
लिप्त_होना	_onto_nodes	भुँइफोर
कुण्डलनी	_onto_nodes	संगीतात्मक
दाम_बढ़ना	_hypernym	सीमा_रक्षक
भंडारा_ज़िला	_onto_nodes	खपाची
भठूरा	_onto_nodes	साया
छासठ	_onto_nodes	संगीतात्मक
गेंडा	_hypernym	पाजीपन
ईड्य	_hypernym	शालाक्य
महागज	_onto_nodes	छलशून्यता
वल्लरी	_onto_nodes	भुँइफोर
मित्रबिन्दा	_hypernym	अच्छी_बात
कड़लूर_जिला	_hypernym	ऋग्वेद
ओलिंपिक_देवता	_onto_nodes	भुँइफोर
कटनी_शहर	_attributes	बनासकांठा_जिला
नारेबाजी_करना	_hypernym	पर्णकार
संकाय	_hypernym	कोरी
निम्न_कुलीन	_onto_nodes	मान्यताप्राप्त
सेशिल्जी_रुपया	_onto_nodes	भुँइफोर
बेनकाब	_onto_nodes	व्यास
सिंधी	_onto_nodes	तुरंगिका
इंतिज़ार	_onto_nodes	चालचलन
अमर-वल्ली	_onto_nodes	बहवाना
क़व्वाली	_hypernym	रग्बी
वर्णिकवृत्त	_entailment	साम्बमित्र
विपरीतार्थी	_onto_nodes	इतेक
सोच_लेना	_hypernym	कुवैतवासी
नारदपरिव्राजकोपनिषद्	_hypernym	पूरनपोली
धेंकनाल_शहर	_hypernym	तालुकंटक
जिंदा_करना	_hypernym	रिवायत
किस्सा	_hypernym	क़िस्तों_में
टूर्नामेंट	_onto_nodes	साया
नानाकंद	_hypernym	स्टेट_बैंक_ऑफ_पटियाला
रजनीहासा	_onto_nodes	न्यूज़_पेपर
दुगना_होना	_onto_nodes	टेलिफ़ोन_नंबर
नाभिकंटक	_onto_nodes	मुखशोधन
पेट_स्कैनर	_onto_nodes	ज्येष्ठत्व
तुंबुरु	_onto_nodes	सृंजय
बेलूर_ज़िला	_onto_nodes	अनिष्टकर
अर्धसैनिक_बल	_hypernym	उनतालीस
लघु	_onto_nodes	रोकनेवाला
नदीश	_onto_nodes	खपाची
टघलन	_onto_nodes	बहवाना
ख़ुश	_hypernym	अभिस्यन्दी
७६वाँ	_onto_nodes	प्रतिधावन
झेप	_hypernym	आचार्य_रुद्रट
नासादण्ड	_onto_nodes	मोतियदाम
आनंदवर्धन	_hypernym	उत्तम_ग्रंथकार
कुलकलंक	_hypernym	ताल-मेल
सुगन्ध	_onto_nodes	सीकर
अलग़ोजा	_onto_nodes	सीकर
हैक्टेयर	_hypernym	सूरत_जिला
इन्टरनेट	_hypernym	एन्टिना
लपेट	_onto_nodes	अतरवन
तिरुविथान्कूर	_onto_nodes	अंगिरस_ऋषि
हर्षाना	_onto_nodes	भुँइफोर
शुक्रग्रह	_onto_nodes	पैरदान
सफ़ेद_करना	_hypernym	निलसिर
पोलैंड-वासी	_hypernym	निरालंब
अनुशिक्षण	_onto_nodes	सीकर
रोबदार	_hypernym	प्रसूति_काल
कैम्प	_hypernym	बंदी_गृह
माजू	_hypernym	अभिप्रणय
भुसौरा	_onto_nodes	ज्येष्ठत्व
चरवाही	_hypernym	ठाणा_जिला
अरिघ्न	_onto_nodes	भुँइफोर
सोनिया	_onto_nodes	ग्रोस
निशामुख	_hypernym	शनिदेव
भद्दी	_onto_nodes	सीकर
स्त्रीलिंग	_onto_nodes	खपाची
जहाँ-तहाँ	_hypernym	उनतालीस
अम्बेडकर_नगर_जिला	_hypernym	सुहलाना
जतुकारी	_onto_nodes	व्यास
प्रतिरोपण	_onto_nodes	अमानुष
कार्य_कुशलता	_hypernym	अभिरना
गोकुशी	_onto_nodes	बहवाना
सोम_बाजार	_onto_nodes	खपाची
बेदमुश्क	_onto_nodes	प्रतिधावन
अलिल	_hypernym	नवलता
झलाईग़र	_hypernym	सर्वरी
ऐश्वर्यप्रद	_hypernym	प्रसूति_काल
अगणतंत्रात्मक	_onto_nodes	बाणगङ्गा_नदी
नज़रन्दाज़	_onto_nodes	मुखशोधन
एमटी	_onto_nodes	साया
उनचालीसवाँ	_attributes	कटहल
अंधुल	_onto_nodes	तुरंगिका
अहरना	_hypernym	बिलल्ला
बोतल	_onto_nodes	भुँइफोर
खुन्च_बगुला	_hypernym	बेक़रारी
साँभर	_onto_nodes	अवाकी
नोकझोंक	_onto_nodes	बरफिस्तान
वसुविद	_hypernym	मसलन
अंतर्ग्रह	_onto_nodes	अवाकी
लालमी	_hypernym	धनबाद
सिन्धुवेषण	_onto_nodes	बाणगङ्गा_नदी
वन्य_पशु	_onto_nodes	बांदीपुरा
प्राकृतिक_जलाशय	_onto_nodes	खपाची
विध्वंसनीय	_hypernym	रेकॉर्ड_किया
इठलाना	_hypernym	माइक्रोनेशिया_के_संघीकृत_राज्य
गुरुवारी	_onto_nodes	भुँइफोर
बम्बैया	_onto_nodes	सृंजय
गोड्डा_शहर	_hypernym	निलसिर
धुँआना	_onto_nodes	ज्येष्ठत्व
मँगरैला	_onto_nodes	अविपर्यय
सुल्तानपुर	_hypernym	पेचीला
कुछ_उठा_नहीं_रखना	_onto_nodes	अनिष्टकर
शयन-एकादशी	_onto_nodes	साया
अविक्रीत	_hypernym	धाव_पट्टी
उच्चैःश्रवा	_onto_nodes	पिछलगा
कैरम-बोर्ड	_hypernym	सिंधुजा
काँवकाँव_करना	_hypernym	सहलाई
सुषुम्ना_नाड़ी	_onto_nodes	खपाची
देवमंदिर	_onto_nodes	चंद्राकार
मृगभक्षा	_hypernym	दुरुस्त
यत्नरहित	_hypernym	कलंकरहित
द्विपाधिप	_onto_nodes	सीकर
तापमापक_यंत्र	_onto_nodes	सृंजय
अनुपातकी	_hypernym	रणभूमि
पेटंट	_hypernym	एन्टिना
परिपालक	_onto_nodes	पूर्णचाँद
शक्तुफला	_hypernym	गोचरपिण्ड
नक़्क़ार-खाना	_onto_nodes	मोतियदाम
लोक-धुन	_hypernym	तक़लीफ़_उठाना
रेडियम	_onto_nodes	साया
प्राणी	_onto_nodes	45
अनुभाव	_onto_nodes	अवाकी
फर्ज_करना	_hypernym	पीवर
आरोप्य	_onto_nodes	न्यूज़_पेपर
51वां	_onto_nodes	खपाची
समय_आने_पर	_onto_nodes	मेक्सिको
लाज़िमी	_onto_nodes	सीकर
दोलिका	_onto_nodes	छलशून्यता
सहवसु	_hypernym	बायोलाजी
महावाक्य	_onto_nodes	सीकर
शंपाक	_onto_nodes	बांदीपुरा
खुरदरा	_hypernym	बरामीटर
पैकार	_onto_nodes	रङ्गमहल
मुर्शिदाबाद_जिला	_onto_nodes	व्यास
विहित	_hypernym	जल-स्थलचर
अभिव्यंजन	_onto_nodes	रङ्गमहल
गुहारी	_onto_nodes	सृंजय
फार्मास्युटिकल	_hypernym	धाव_पट्टी
अभिनयशाला	_hypernym	क़ाबिलीयत
जजु	_hypernym	पितृ-ऋण
अंग-विकार	_onto_nodes	भुँइफोर
गादुर	_hypernym	नरपति
डाइनोसोर	_hypernym	हक़ारत
तैराना	_hypernym	धनबाद
आनतान	_onto_nodes	बहवाना
निर्विवाद	_hypernym	नरपति
उपादेयता	_onto_nodes	भुँइफोर
दही_घड़ा	_hypernym	इतिवृत्त
ज़ुल्मो_सितम	_onto_nodes	व्यास
कटुत्व	_onto_nodes	सीकर
नीलकमल	_hypernym	रणभूमि
ग्वाटेमाला_देश	_onto_nodes	चालचलन
निबहुर	_hypernym	रेहुआ
सीपीआई	_onto_nodes	भुँइफोर
आईएएस	_hypernym	लाक्षणिक
अस्थूल	_hypernym	ऐथलीट
इरेडिएटेड_डीहाइड्रोसाइटोस्टेरोल	_hypernym	कोरी
निरालंब	_onto_nodes	सीकर
आदिष्ट	_onto_nodes	सृंजय
श्रुतकर्मा	_onto_nodes	भुँइफोर
धनवन्त	_hypernym	कमलासन
मजा	_onto_nodes	रङ्गमहल
अनिर्णित	_hypernym	बायोलाजी
सुघराई	_onto_nodes	भुँइफोर
वनराज_आम	_hypernym	गोचरपिण्ड
चिन्हानी	_hypernym	आराति
क्रौंच_द्वीप	_onto_nodes	सृंजय
अष्टभाव	_onto_nodes	बाणगङ्गा_नदी
गिलिम	_hypernym	भयानक_रस
चिकनी_चुपड़ी_बातें_करना	_onto_nodes	प्रतिधावन
एक_भी_नहीं	_hypernym	मौत_के_घाट_उतारना
पेंशनरधारी	_hypernym	अरबी_प्रायद्वीप
स्कंद_उपनिषद्	_onto_nodes	व्यास
अवैधनिरोध	_onto_nodes	राजकोषीय
ध्वंसित	_onto_nodes	भुँइफोर
मुरौवत	_hypernym	नरपति
आकाशमूली	_hypernym	आयोधन
नीलनी	_hypernym	इकतारा
दोगलापन	_onto_nodes	भुँइफोर
वक्रोक्ति_अलंकार	_hypernym	टेलिफून
अनागतविधाता	_hypernym	गोचरपिण्ड
कवित्त	_hypernym	असंभव
देशकार_राग	_hypernym	निरालंब
दोज़ख	_hypernym	धाव_पट्टी
प्रॉडक्शन	_hypernym	परभणी_शहर
अरण्या	_onto_nodes	भुँइफोर
जिम्मेवार	_onto_nodes	संगीतात्मक
वादित्र	_hypernym	उपकर्त्ता
चित्रमृग	_onto_nodes	अवाकी
पण्यशाला	_hypernym	अभिरना
बँसमुरगी	_onto_nodes	ज्येष्ठत्व
डेटनेटर	_hypernym	आर्टिफिशल
नवलता	_hypernym	दुनियाँ
इलविला	_hypernym	जुड़ाई
घाना-वासी	_onto_nodes	तरफदार
हाथ_जोड़ना	_hypernym	निरालंब
चिंतामुक्त	_hypernym	विश्वभुजा
देरानी	_onto_nodes	सीकर
नया_वर्ष	_onto_nodes	मेक्सिको
सेरछिप_जिला	_hypernym	न्यग्रोधिका
जवाबी	_onto_nodes	भुँइफोर
उचड़ना	_onto_nodes	रंगहीन
बियाड़	_hypernym	उनतालीस
पवनकुमार	_attributes	अन्तरीप
एशिया	_onto_nodes	प्रतिधावन
पाथोन	_onto_nodes	ईयर
प्लक्षा	_onto_nodes	सीकर
ठाट-बाट	_onto_nodes	अवाकी
रेजा	_onto_nodes	सीरियाई_पौंड
रूढ़िवादी	_hypernym	सृंजय
झज्जर_शहर	_onto_nodes	भुँइफोर
जॉइन्ट_कमिश्नर	_hypernym	गिट्टक
गोल_तकिया	_hypernym	निलसिर
ज़रदोज़ी	_onto_nodes	चंद्राकार
हज़ारवाँ	_attributes	पवित्र_करना
दूध_उत्पाद	_onto_nodes	बहवाना
स्वीकार्य	_hypernym	कैनबरा
सेवा-शुश्रूषा	_onto_nodes	रङ्गमहल
अरिनिपात	_hypernym	चूअरी
मज़ार	_hypernym	निलसिर
शम्भुगिरि	_hypernym	हरफ़न_मौला
राष्ट्र_निष्कासित	_hypernym	उनतालीस
आयरलैंड_वासी	_hypernym	बिलल्ला
जोगाड़	_onto_nodes	सीकर
लोहाँगी	_onto_nodes	बहवाना
बेसनौटी	_onto_nodes	सृंजय
पाँच_सौ	_hypernym	आपसदारी
हवन	_onto_nodes	सीकर
सोहन_पापड़ी	_onto_nodes	साया
लोहड़ा	_onto_nodes	पूर्णचाँद
करम	_onto_nodes	चोरबदन
आगेपीछे	_hypernym	गोचरपिण्ड
लेडी_डॉक्टर	_onto_nodes	मान्यताप्राप्त
सेहुर	_onto_nodes	इम्तिहान
बॉय_फ्रेंड	_hypernym	घोषणा
जटा	_hypernym	बंबई_आम
आसिखा	_onto_nodes	खपाची
महाक्रतु	_hypernym	56
बहिष्कार	_hypernym	प्रत्यूस
सीमांत	_onto_nodes	व्यास
वैदर्भी	_hypernym	उबराई
विरेचक	_hypernym	फाँस
जार्डनी	_onto_nodes	खपाची
परवन	_onto_nodes	सृंजय
बारबैडोस_देश	_onto_nodes	खपाची
अगण्ड	_onto_nodes	व्यास
लाइबेरिया	_onto_nodes	सत्यसन्ध
कंपोस्ट_खाद	_onto_nodes	व्यास
कष्टमय	_onto_nodes	सृंजय
रबाना	_hypernym	अभिव्यक्तिशील
अभ्यासहीनता	_onto_nodes	सीकर
असामंजस्यता	_onto_nodes	मान्यताप्राप्त
अन्तर्वर्ती	_onto_nodes	सीकर
अनन्तकाय	_hypernym	सृंजय
जनेन्द्रिय	_hypernym	द्विजाति
अनुयुक्त	_onto_nodes	भुँइफोर
दाँना	_onto_nodes	साया
हैन	_onto_nodes	खपाची
सुख-सुविधा	_hypernym	जल-स्थलचर
अनमिल	_hypernym	दक्षिण_अमेरिकी_देश
अंधा_तारा	_onto_nodes	सत्यसन्ध
कर्क-रेखा	_onto_nodes	न्यूज़_पेपर
अजीर्ण	_hypernym	दीर्घदण्डक
पुश्ती	_onto_nodes	व्यास
षट्-तिला_एकादशी	_hypernym	जेट_हवाई_जहाज
वचर	_onto_nodes	सीकर
कालकूट	_onto_nodes	अनिष्टकर
शॉर्ट_पिच_बाल	_hypernym	ऐथलीट
अर्धुक	_hypernym	निरालंब
उबला_चावल	_onto_nodes	भुँइफोर
पानागार	_onto_nodes	मेक्सिको
शीतकर	_onto_nodes	संगीतात्मक
फेक_शहर	_onto_nodes	चंद्राकार
बगलीबाँह	_hypernym	एन्टिना
मयस्सर_होना	_hypernym	लिलाट
प्रधान	_hypernym	अभिरना
तर्क_शास्त्र	_onto_nodes	रङ्गमहल
तपावंत	_onto_nodes	अवाकी
राजार्क	_onto_nodes	बांदीपुरा
भ्रमण-प्रेमी	_onto_nodes	प्रतिधावन
सिहुला	_hypernym	पब्लिक_प्रॉसिक्यूटर
नामज़द_करना	_hypernym	वल्वग
किफायत	_hypernym	रियाज
तुरीयातीत_उपनिषद	_hypernym	ताल-मेल
आरम्भ-बिन्दु	_hypernym	हक़ारत
वाहेगुरु	_attributes	आंख_मूंदना
सोता	_onto_nodes	खपाची
गुरुत्व_मध्य	_onto_nodes	सत्यसन्ध
अधोबंधन	_onto_nodes	भुँइफोर
मार्जिन	_onto_nodes	सृंजय
१००वां_वर्ष	_hypernym	पद_व्याख्या
प्रघस	_hypernym	मूत्रनाली
भोपाल_जिला	_hypernym	फ़रमाइश_करना
कार्यांतराल	_hypernym	सीमोल्लंघन
आनकदुंदुभि	_onto_nodes	साया
प्राचीन_व्यक्ति	_hypernym	परभणी_शहर
यंत्र-रचना	_hypernym	मांगन_शहर
वर्ग_ओ	_onto_nodes	भुँइफोर
नीदरलैण्डी	_onto_nodes	साया
क्वार	_hypernym	गैंगवॉर
अनुप्रवेश	_hypernym	राज्य_क्षेत्र
उपनंद	_onto_nodes	अपमान_कर्त्ता
जनन_इन्द्रिय_सम्बन्धी	_hypernym	पर्णकार
अन्तःपट	_onto_nodes	अवाकी
जंबू	_hypernym	मानवकृत
कलिंदक	_onto_nodes	भुँइफोर
मज़बूत_बनना	_hypernym	पब्लिक_प्रॉसिक्यूटर
पेट्रौलपम्प	_onto_nodes	अनिष्टकर
श्रुतवर्मा	_onto_nodes	सृंजय
प्रसन्न	_onto_nodes	बांदीपुरा
जार्ज_द्वितीय	_hypernym	निलसिर
प्रतिरोधक-तंत्र	_hypernym	द्विजाति
दुबे	_onto_nodes	सृंजय
पुष्पहासा	_hypernym	सिंधुजा
विराट्	_onto_nodes	सत्यसन्ध
रुदन	_onto_nodes	खपाची
नन्दोई	_onto_nodes	खपाची
सोनापुर_शहर	_hypernym	रोगजन्य
वाद्य_यंत्र_सुर	_hypernym	उनतालीस
प्लास्टिक_सर्जरी	_onto_nodes	भुँइफोर
बेगि	_onto_nodes	भुँइफोर
दंभहीन	_onto_nodes	प्रतिधावन
स्मरकथा	_onto_nodes	संगीतात्मक
शिम्बी	_onto_nodes	साया
बघेला	_hypernym	टेलिफून
अबरी	_onto_nodes	खपाची
मरी	_hypernym	ऐथलीट
अनाच्छादन	_hypernym	आपसदारी
त्रिचूर_शहर	_onto_nodes	ईयर
यनम_शहर	_hypernym	चाण्डालिनी_दोहा
एण्टीबॉडी	_hypernym	बन्दाक
गुड़गुड़ी	_onto_nodes	प्रतिधावन
उड़नतश्तरी	_hypernym	तिष्य
निष्क्रियता	_onto_nodes	व्यास
ददिया	_onto_nodes	सीकर
काल्पनिक_प्राणी	_onto_nodes	संगीतात्मक
आक्रामक	_onto_nodes	भुँइफोर
अंबा	_onto_nodes	संगीतात्मक
अयाज्यत्व	_onto_nodes	भुँइफोर
दो-चार_होना	_hypernym	अभिस्यन्दी
एकत्र_होना	_hypernym	गेल्हा
पंजीकर	_hypernym	संत_नामदेव
अनतिक्रमण	_hypernym	चूँ_चाँ
मेध्य	_onto_nodes	पैरदान
कम्पक	_onto_nodes	सत्यसन्ध
झल्लरी	_onto_nodes	तुरंगिका
धृतदेवा	_onto_nodes	न्यूज़_पेपर
आलोकचित्र	_onto_nodes	अरदल
प्रहेति	_onto_nodes	अपमान_कर्त्ता
चील्लड़	_hypernym	गोचरपिण्ड
गरारी	_hypernym	सह_संक्रमण
लिंग_शरीर	_onto_nodes	अनतुला
विनिमय_व्यापार	_onto_nodes	ज्येष्ठत्व
अधिदिवस	_onto_nodes	ग्रोस
वज्रधर	_hypernym	मसलन
औटावनी	_hypernym	थाम_लेना
व्यावसायिक	_onto_nodes	चालचलन
तमेला-झमेला	_hypernym	पब्लिक_प्रॉसिक्यूटर
आच्छिन्न	_onto_nodes	सृंजय
जुआ-घर	_onto_nodes	संगीतात्मक
धूप_छाँह़	_onto_nodes	भुँइफोर
इन्सान	_onto_nodes	भुँइफोर
इन्द्रशस्त्र	_onto_nodes	खपाची
फरवरी	_onto_nodes	मोतियदाम
बर्धमान_शहर	_onto_nodes	रङ्गमहल
कुतरना	_hypernym	पाककर्म
उच्चतम_न्यायालय	_hypernym	अबीरा
लाल_किला	_hypernym	हरफ़न_मौला
हशीश	_onto_nodes	सृंजय
अपूर	_onto_nodes	शीघ्र
मनमथ	_onto_nodes	अनतुला
अवसादित	_onto_nodes	भुँइफोर
चामा_बगुला	_onto_nodes	सृंजय
चू_चू	_onto_nodes	संगीतात्मक
अन्तर्द्धान	_onto_nodes	रङ्गमहल
खारिज_कर_देना	_onto_nodes	खपाची
नागेसर	_onto_nodes	खपाची
ज़िराक्स	_onto_nodes	संगीतात्मक
घुमाव-फिराव	_hypernym	अवस्कन्दित
पांडुचेरी	_hypernym	उनतालीस
थोकदारी	_hypernym	श्वेतकांडा
होंडुरस	_hypernym	लीबियन_दिरेम
कपास्सी	_onto_nodes	ज्येष्ठत्व
पूजक	_onto_nodes	व्यास
पिल्लू	_hypernym	रेकॉर्ड_किया
अमेजन_नदी	_onto_nodes	अवाकी
आपसी	_hypernym	अभिस्यन्दी
हैंडपंप	_hypernym	बेलिजी_डालर
गाली_गलौज	_onto_nodes	सृंजय
नीमुच_शहर	_onto_nodes	अवाकी
बूई	_onto_nodes	सीकर
संवर्धक	_hypernym	रहस्योद्घाटक
बीज	_hypernym	रंगहीन
मक्का_की_रोटी	_hypernym	किलकिला
होशियारपुर	_onto_nodes	अन्न_ग्रहण
ख़ुद्दार	_hypernym	अवधायक
अन्त्र	_onto_nodes	सृंजय
जयावती	_hypernym	कोची_शहर
दागना	_onto_nodes	संगीतात्मक
धनवंत	_hypernym	उत्तुंग
अरबिस्तान	_onto_nodes	आईआईटी
व्यंजनाक्षर_झ	_hypernym	दीर्घदण्डक
परगना	_onto_nodes	परियोजना
अदित	_onto_nodes	जीर्ण-शीर्ण
वैरिणी	_onto_nodes	सृंजय
महासहा	_onto_nodes	ईयर
तालुकंटक	_hypernym	बकनाल
दुर्व्यसनी	_onto_nodes	बहवाना
सगोत्री	_hypernym	मंद-मंद
अपारा	_hypernym	कुवैतवासी
कैसे	_onto_nodes	रखैया
चपटा	_hypernym	वसुविद
वृषपर्व्वा	_onto_nodes	सृंजय
भीष्मकुंड	_onto_nodes	छलशून्यता
अचरज	_hypernym	फरीक
गैरमनकूला	_hypernym	प्रसूति_काल
लजाना	_onto_nodes	ईयर
असान्निध्य	_onto_nodes	भुँइफोर
वसूली	_onto_nodes	अवाकी
मनहूसियत	_onto_nodes	सूपाबेना
भयावन	_hypernym	फ़ार्रूख़ाबाद
अवाच्य	_onto_nodes	संगीतात्मक
आज्ञापत्र	_entailment	इष्टता
केंदुझरगढ़_जिला	_hypernym	पलक्कड_जिला
राज-घाट	_onto_nodes	अपमान_कर्त्ता
सिफलिस	_onto_nodes	अनतुला
हिसार_शहर	_hypernym	वेंडर
गंदा_लिखना	_hypernym	डाक
उल्काखंड	_onto_nodes	अव्यापकता
नकुलौष्ठी	_hypernym	ऐथलीट
प्रतिस्थापित	_hypernym	वराहकान्ता
मिलता-जुलता	_onto_nodes	चालचलन
यूका	_hypernym	जन्मपत्री
स्त्री	_hypernym	ठाणा_जिला
संगणक	_hypernym	अनन्तकाय
जुआबाज़	_hypernym	ताल-मेल
भैष्मकी	_onto_nodes	भुँइफोर
आक्ष	_hypernym	सूरत_जिला
अनुद्यत	_onto_nodes	अनतुला
पगा	_hypernym	कलहन्तारिता
सुनाई_पड़ना	_hypernym	नरपति
पत्रहीन	_onto_nodes	बाणगङ्गा_नदी
वंशी	_onto_nodes	सृंजय
शठी	_hypernym	जांच
पदोन्नति_देना	_onto_nodes	चालचलन
हिडिम्बा	_onto_nodes	जीर्ण-शीर्ण
चालीसवाँ_साल	_hypernym	खराद_कर्मी
ग्वालपारा_ज़िला	_onto_nodes	साया
मुकाम	_onto_nodes	छलशून्यता
मोथरा	_hypernym	निरालंब
गुहावासी	_onto_nodes	पैरदान
पीकना	_onto_nodes	छलशून्यता
अफ़रातफ़री	_onto_nodes	भुँइफोर
मानवकृत	_hypernym	पुष्टता
गप_हाँकना	_hypernym	इतिवृत्त
क्षार	_hypernym	परलोक_सिधारना
विक्रय	_onto_nodes	सूपाबेना
पखाना	_onto_nodes	पिकाङ्ग
जलसूचि	_hypernym	ऐल्प्स_पर्वत
हाथ_की_सफाई	_onto_nodes	रङ्गमहल
_चूड़ा	_onto_nodes	भुँइफोर
लैबोरेटरी	_hypernym	अभिरना
धर्मवासर	_onto_nodes	भुँइफोर
फ़ील्ड	_onto_nodes	व्यास
वनासुर	_onto_nodes	मोतियदाम
मर्द्दल	_hypernym	झिड़की
झाँकना	_hypernym	ताल-मेल
गांधी_जयंती	_hypernym	लालची
इफ्तिरा	_hypernym	प्रसूति_काल
कमेर_भाषा	_hypernym	मादा_कोश
अनडीठ	_hypernym	सीमोल्लंघन
क्रेप	_onto_nodes	जीर्ण-शीर्ण
बौढ_शहर	_onto_nodes	चोरबदन
आयु_काल	_onto_nodes	सीकर
फिक्की	_onto_nodes	कंधे_पर_आना
गजपति_ज़िला	_onto_nodes	चोरबदन
अधेड़पन	_hypernym	अन्हाना
आठ	_hypernym	पलक्कड_जिला
संचयन	_onto_nodes	व्यास
वित्त_मंत्रालय	_onto_nodes	नन्दा
कॉफी_पावडर	_hypernym	कर्त्तव्यवादी
संबंध	_onto_nodes	रङ्गमहल
मुसाफ़िर	_hypernym	नम्य_बनाना
अपवचन	_onto_nodes	अरदल
वायसांतक	_hypernym	नरपति
केशरूपा	_hypernym	दयामय
हौज	_hypernym	गोपनीयता
परमात्मा	_hypernym	नरपति
जिमनिशियम	_hypernym	इतिवृत्त
एक्यानवे	_onto_nodes	खपाची
आमलासार_गंधक	_hypernym	गिट्टक
गाबाँ	_onto_nodes	नन्दा
अश्वगन्धा	_hypernym	सहलाई
हीरक	_onto_nodes	ज्येष्ठत्व
तारकशी	_onto_nodes	तुरंगिका
अक्ल_के_घोड़े_दौड़ाना	_hypernym	अग्निज_पाषाण
अनपेक्षत्व	_onto_nodes	चंद्राकार
बोंगाईगाँव_शहर	_hypernym	रेकॉर्ड_किया
लक्सेमबोर्गी	_onto_nodes	सूपाबेना
ज़ुंहेबोटो_जिला	_hypernym	बिलल्ला
अजेंडा	_onto_nodes	सीकर
शोणितपुर_नगर	_onto_nodes	न्यूज़_पेपर
आयुष्मान	_onto_nodes	सृंजय
बिंगी	_hypernym	उभय
नज़राना	_onto_nodes	ज्येष्ठत्व
बंबइया	_onto_nodes	अवाकी
सावित्री_देवी	_onto_nodes	सीकर
बीजवाहन	_onto_nodes	संगीतात्मक
नवप्रवर्तन	_hypernym	शतपथी
अब्बास	_hypernym	अभिरना
पटना	_onto_nodes	भुँइफोर
हार_जाना	_hypernym	दंडात्मक
अनामिष	_onto_nodes	सृंजय
नाच	_onto_nodes	भुँइफोर
तालमखाना	_hypernym	बालेश्वर_ज़िला
लक्ष्य_स्थल	_onto_nodes	भुँइफोर
स्कीपर	_onto_nodes	अपमान_कर्त्ता
मिडल	_hypernym	अबीरा
56	_onto_nodes	साया
खेल_प्रतियोगिता	_onto_nodes	चोरबदन
85	_onto_nodes	ईयर
बलगम	_onto_nodes	हिलवाना-डोलवाना
प्राकृतिक_रूप_से_सड़नशील	_onto_nodes	बहवाना
ब्लाटिंग_पेपर	_onto_nodes	इतेक
हस्त-लेख	_hypernym	अनासक्त
पाट	_onto_nodes	बहवाना
सदावर्त	_onto_nodes	तोकक
बृहस्पत	_onto_nodes	गड़गड़ा
निस्तार_पाना	_hypernym	अचंभित
तालबेन	_onto_nodes	सृंजय
ऑटो-रिक्शा	_hypernym	सूरत_जिला
ख़ूबसूरत	_hypernym	उनतालीस
लेंढ़ा	_hypernym	करुणी
दंडित	_hypernym	वर्णार्ह
पेरु_गणराज्य	_onto_nodes	ज्येष्ठत्व
दनु	_onto_nodes	रङ्गमहल
माल्यवान्	_onto_nodes	रखैया
आतशक	_onto_nodes	पैरदान
क़रीब	_onto_nodes	सत्यसन्ध
मीज़ोरमवासी	_hypernym	निन्दा
निंदासा	_onto_nodes	सीकर
एमहैरिक	_hypernym	ठाणा_जिला
इंजैक्शन	_hypernym	पब्लिक_प्रॉसिक्यूटर
चचाजाद	_onto_nodes	भुँइफोर
आत्मानुशासन	_hypernym	नाज़ुक_बाल
अप्रतिभट	_hypernym	ठाणा_जिला
अत्यन्त_गरीबी	_hypernym	अवगाहनक्षम_उपकरण
सदावर्त्ती	_hypernym	एवरेस्ट
भूनना	_onto_nodes	संगीतात्मक
रानी_लक्ष्मीबाई	_onto_nodes	अनिष्टकर
चुनरिया	_onto_nodes	ईयर
कृष्ण_उपनिषद	_hypernym	गोचरपिण्ड
बनभैंसा	_hypernym	स्टेट_बैंक_आफ_हैदराबाद
आउ	_onto_nodes	बहवाना
वायसांतक	_hypernym	अखज
एरनाटिक्स	_hypernym	पुष्टता
अभूतोपमा	_onto_nodes	संगीतात्मक
93	_hypernym	पब्लिक_प्रॉसिक्यूटर
मौनी	_onto_nodes	ईयर
अघहरण	_onto_nodes	ज्येष्ठत्व
लोक-निन्दा	_onto_nodes	मार्ग-दर्शक
वार_करना	_hypernym	अभिरना
दमोड़ा	_hypernym	चन्द्र_बिम्ब
रेस्त्रां	_hypernym	अभिरना
पितरिशूर	_onto_nodes	टेलिफ़ोन_नंबर
आचरित	_hypernym	ताल-मेल
कज़ाकवासी	_onto_nodes	सृंजय
प्रस्ताव	_onto_nodes	भुँइफोर
अनभिसंधान	_onto_nodes	सृंजय
तिमी	_onto_nodes	व्यास
मूड	_onto_nodes	भुँइफोर
कुंभकरण	_onto_nodes	भुँइफोर
खास_तौर_से	_hypernym	निरालंब
रंगरेली	_hypernym	वाह्लीक_घोड़ा
थाइराइड_ग्रन्थि	_hypernym	चूँ_चाँ
अन्तर्वर्ग	_hypernym	लाल_साग
लीम्बू	_onto_nodes	भुँइफोर
लेन-देन	_hypernym	फ़रमाइश_करना
कट्टरपन	_hypernym	गोचरपिण्ड
छाया-चित्र	_hypernym	जल-स्थलचर
कालादाना	_onto_nodes	संगीतात्मक
वज्रजित्	_hypernym	आनंदक
मारिशस_द्वीप	_onto_nodes	अनिष्टकर
विद्युत_धारा_प्रवाह	_hypernym	बेलिजी_डालर
आदर्य	_hypernym	संजाब
पटरी_पर्यन्त	_hypernym	जलरंड
क्रम	_onto_nodes	ईयर
अभीष्टा	_hypernym	ताल-मेल
अनसूय	_onto_nodes	बहवाना
ईबीसीबी	_onto_nodes	बहवाना
रकबामापक	_hypernym	फ़ितरत
अल्पवर्तक	_onto_nodes	भुँइफोर
तद_उपरांत	_onto_nodes	भुँइफोर
छुक_छुक	_onto_nodes	सीकर
ईठि	_onto_nodes	सृंजय
बघेरा	_hypernym	पंजा
कतलेआम	_hypernym	88
नेकलेस	_onto_nodes	सृंजय
डायफ़्राम	_onto_nodes	सृंजय
आँख_की_पुतली	_onto_nodes	भुँइफोर
भारतीय_क्रिकेट_कंट्रोल_बोर्ड	_onto_nodes	सत्यसन्ध
सोखरी	_onto_nodes	ईयर
रंग_महल	_onto_nodes	ज्येष्ठत्व
स्टाइल_में_करना	_onto_nodes	सत्यसन्ध
भूदेवता	_onto_nodes	खपाची
अधिरोहण	_onto_nodes	रङ्गमहल
बैंड_बाजा	_hypernym	सह_संक्रमण
शुभ	_onto_nodes	बिलल्ला
दन्तपंक्ति	_hypernym	धाव_पट्टी
आदमचश्म_घोड़ा	_onto_nodes	सीकर
शस्त्रसज्जित-वाहन_दस्ता	_onto_nodes	रङ्गमहल
ट्रैवल_एजेन्सी	_onto_nodes	मुखशोधन
चिड़िहार	_hypernym	स्वराक्षर_आ
रसौट	_onto_nodes	सीकर
दुखदाई	_onto_nodes	बहवाना
प्रौढ़ावस्था	_onto_nodes	भुँइफोर
कैस्पियन_सागर	_onto_nodes	भुँइफोर
अमावट	_hypernym	आकूत
द्विदश	_onto_nodes	झटा_झट
बिसरमगंज	_onto_nodes	भुँइफोर
जिह्वामूल	_onto_nodes	चोरबदन
गुरूवार	_onto_nodes	खपाची
अचाना	_hypernym	मसलन
चिंताग्रस्त	_hypernym	ऊपरी_सिआंग_ज़िला
खूना-खून_होना	_hypernym	पब्लिक_प्रॉसिक्यूटर
ढाबर	_hypernym	अभिप्रणय
अनुदैर्ध्य	_hypernym	हंसी-मज़ाक़
सुगंधिफल	_onto_nodes	रङ्गमहल
नागिनी	_hypernym	तिरुवनमलई_शहर
सितुही	_onto_nodes	भुँइफोर
सिंहिनी	_hypernym	राखी_पूनो
साम्प्रतिक	_hypernym	धाव_पट्टी
भिनभिनाना	_onto_nodes	सृंजय
तीवर	_hypernym	ज्योतिष्मती
काला_चन्दन	_onto_nodes	सत्यसन्ध
फोर्थ	_onto_nodes	इतेक
गटर	_hypernym	अभिप्रणय
कशीदाकार	_hypernym	मीठीगोली
भगनी	_onto_nodes	बांदीपुरा
हस्त-भाग	_hypernym	प्रसिति
प्रौढ़-शिक्षा	_hypernym	कीटनाशक
प्रॉपर्टी	_hypernym	सुनामद्वादशी
बहिश्त	_hypernym	गोचरपिण्ड
चैनसेल	_onto_nodes	भुँइफोर
मॉंटेनेग्रो	_hypernym	उघढ़ना
ताम्बूल	_onto_nodes	ग्रोस
दीक्षा	_onto_nodes	अनिष्टकर
राष्ट्रीय_सुरक्षा_परिषद	_hypernym	युगान्तराल
चीन्हना	_hypernym	मझेला
उत्परिवर्ती	_onto_nodes	बांदीपुरा
अभिवंदित	_hypernym	पुष्टता
उपापचय	_onto_nodes	संगीतात्मक
कत्थई	_onto_nodes	चोरबदन
लिपटना	_onto_nodes	भुँइफोर
गैर-कानूनी_काम	_hypernym	इस्तग़ासा
पचीसवीं_वर्षगाँठ	_onto_nodes	भुँइफोर
अभिरामी	_onto_nodes	रङ्गमहल
सोनेपुर_ज़िला	_onto_nodes	भुँइफोर
आस-पास	_onto_nodes	तुरंगिका
बुलगारियन	_onto_nodes	भुँइफोर
विज़ुपुरम_जिला	_onto_nodes	खपाची
निष्क्रिय	_hypernym	चूँ_चाँ
उदसना	_onto_nodes	भुँइफोर
वैक्सीन	_hypernym	अभिमुखता
परिशोधित	_onto_nodes	संगीतात्मक
नलबारी	_hypernym	व्यंजनाक्षर_ज
नेत्र_मुद्रा	_hypernym	अर्धसहमत
काष्ठीय	_hypernym	ध्वांतोन्मेष
राजपत्नी	_onto_nodes	शीघ्र
दुक्कड़	_onto_nodes	सत्यसन्ध
काली_जीभवाला	_hypernym	टायर
हजूर	_onto_nodes	सृंजय
प्रयत्नपूर्वक	_hypernym	चित्र-रेफ
वैष्णव_मां	_hypernym	काबू
मियादी	_hypernym	जैन_धर्म
अपद	_hypernym	बुनियादी
त्रिपुरमल्लिका	_onto_nodes	ईयर
झील	_onto_nodes	खपाची
अतिनाभ	_hypernym	टेलिफून
संपदा	_hypernym	विस्मित_होना
दिशाचक्षु	_onto_nodes	ग्रोस
रामद्वादशी	_hypernym	जल-स्थलचर
दस्तख़त	_onto_nodes	तुरंगिका
काशिराज	_onto_nodes	ज्येष्ठत्व
अदद	_onto_nodes	भुँइफोर
फड़कना	_onto_nodes	अवात
विश्लेषक	_hypernym	सप्तक
अपरामृष्ट	_hypernym	गँठबंधन
आदमखोर	_onto_nodes	दक्षिण_२४_परगना_जिला
डाउन	_onto_nodes	सीकर
राजपुत्री	_hypernym	श्वसनतंत्र
रोआँ	_hypernym	अत्यल्प
अनीतिमान्	_onto_nodes	मुखशोधन
ख़ानदानी_अदावत	_hypernym	पब्लिक_प्रॉसिक्यूटर
योगिनी_एकादशी	_hypernym	रिवायत
मठधारी	_onto_nodes	खपाची
देवी_मंदिर	_onto_nodes	पूर्णचाँद
रामचना	_onto_nodes	अनतुला
मनोवांछित	_onto_nodes	सृंजय
इंदु-वल्ली	_onto_nodes	सत्यसन्ध
केशपाश	_hypernym	धाव_पट्टी
ब्रजबासी	_hypernym	हरफ़न_मौला
चन्द्रवंश्य	_hypernym	मतिमांद्य
गभस्ति	_hypernym	रिवायत
रंभिनी_रागिनी	_hypernym	जल-स्थलचर
छछिया	_onto_nodes	सूपाबेना
गम-गम	_hypernym	ठाणा_जिला
कमोद_राग	_hypernym	खूसट
उचकवाना	_hypernym	अभिरना
नोंगपो	_hypernym	नरपति
रासायनिक_बंध	_onto_nodes	लोक-साहित्य
कुटुंब	_onto_nodes	अवात
आवधिक	_hypernym	अंकुरक
संगतराश	_hypernym	बक्सर_शहर
मेहसाणा	_hypernym	अकृपा
चक्कर_लगवाना	_onto_nodes	निकुरम्ब
घाटिया	_hypernym	रेहुआ
तश्नः	_hypernym	अभिप्रणय
सवालिया	_attributes	हटवा_देना
मिथ्याभियोग	_hypernym	अपूर्ण_भूत
अष्टाश्रि	_onto_nodes	अधिदिवस
जैरे_नदी	_hypernym	कमोबेश
लाचारी	_hypernym	निरालंब
ग्रीनलैण्डवासी	_hypernym	नेगेटिव
अजरबैजानी-भाषा	_hypernym	घटता
बेमौसम	_onto_nodes	इम्तिहान
मोकोक्चुंग_जिला	_hypernym	विधि_विशेषज्ञ
याभ	_onto_nodes	खपाची
सड़ा_गला	_onto_nodes	मेक्सिको
उभड़-खभड़	_hypernym	ब्रिटिश_गयाना
जेनेटिक	_onto_nodes	ईयर
शोथ	_onto_nodes	भुँइफोर
दमक	_onto_nodes	संगीतात्मक
उपक	_hypernym	तुरुप
उच्चरण	_hypernym	कुमंत्रणा
कंपोस्ट_खाद	_onto_nodes	अविपर्यय
गुणी	_hypernym	फूँदा
समस्तीपुर_शहर	_hypernym	गोचरपिण्ड
अवलीक	_onto_nodes	अनतुला
आपबीती	_hypernym	चूँ_चाँ
संगतराश	_onto_nodes	व्यास
श्वसन_क्रिया	_onto_nodes	अनिष्टकर
निम्नलोचा	_onto_nodes	तुरंगिका
अनुदान	_onto_nodes	भुँइफोर
कँकड़ीलापन	_onto_nodes	इतेक
निजीकरण	_hypernym	विनोवा_भावे
अपशब्द_कहना	_onto_nodes	भुँइफोर
दमकला	_hypernym	नेपीडॉ
स्वीडिश_भाषा	_onto_nodes	मान्यताप्राप्त
मध्य_बिंदु	_onto_nodes	अपमान_कर्त्ता
विनोदी_कथा	_hypernym	तिर्यक्_रूप
कट्टरपंथ	_onto_nodes	रङ्गमहल
आनंदप्रद	_onto_nodes	न्यूज़_पेपर
दुलकी	_hypernym	पब्लिक_प्रॉसिक्यूटर
हाँड़ी	_onto_nodes	साया
मेघनाथ	_onto_nodes	आईआईटी
शादी	_hypernym	छोटी_जंगली_मुर्गी
लेखन_उपकरण	_hypernym	अप्रतीयमान
तिपतिया	_onto_nodes	अन्न_ग्रहण
विष्टराश्र	_onto_nodes	भुँइफोर
व्यञ्जनाक्षर_प	_hypernym	तंतुवाद्य
कुवेरक	_hypernym	धाव_पट्टी
वैवर्ण्य	_onto_nodes	भुँइफोर
मुख्यमंत्री	_onto_nodes	सीकर
दु_आना	_hypernym	इरादतन
नम्रतापूर्वक	_hypernym	पितृ-ऋण
तह-बाजारी	_hypernym	निरुपाय
फ़र्माइशी	_onto_nodes	व्यास
विद्यमानता	_onto_nodes	ज्येष्ठत्व
वलवला	_hypernym	शूकवती
चबकना	_onto_nodes	ज्येष्ठत्व
सगुनाँना	_onto_nodes	जेठानी
पाला_लगना	_onto_nodes	चालचलन
जलसबील	_onto_nodes	बाणगङ्गा_नदी
मांगन_शहर	_onto_nodes	आईआईटी
यज्ञ-कुण्ड	_onto_nodes	भुँइफोर
साई	_hypernym	धाव_पट्टी
शीर्षबिन्दु	_onto_nodes	अनिष्टकर
रेडियोबम	_onto_nodes	ज्येष्ठत्व
ढाढ़स_बँधाना	_hypernym	तिपाई
तिरासी	_hypernym	समागम
टोंटा	_hypernym	प्रसूति_काल
बंदूकधारी	_onto_nodes	सीकर
निशाना_साधना	_onto_nodes	चोरबदन
काजालड्डू_आम	_onto_nodes	ताकीद_करना
भाई-बंद	_onto_nodes	बहवाना
पदार्थ_विज्ञान	_hypernym	श्वसनतंत्र
७३वाँ	_hypernym	बिलल्ला
अहमदनगर_जिला	_hypernym	लगलग
पिंक	_onto_nodes	खपाची
लक्तिका	_hypernym	अनुमित
चालना	_onto_nodes	इतेक
कुंडलिया	_onto_nodes	खपाची
गोरख_पंथी	_hypernym	नीलकमल
वृष्ट	_onto_nodes	रखैया
चिकनकारी	_onto_nodes	छलशून्यता
८२वां	_onto_nodes	अनतुला
क़ाबिलीयत	_hypernym	इतिवृत्त
ससुटु	_hypernym	कोरी
ब्रोकरेज_एकाउंट	_onto_nodes	ज्येष्ठत्व
मुष्टियोद्धा	_onto_nodes	खपाची
कोलकाता_जिला	_hypernym	बेलिजी_डालर
अरुन	_onto_nodes	भुँइफोर
उखड़ा	_onto_nodes	सृंजय
बिली_जीन_किंग	_hypernym	सीमोल्लंघन
मेघवाई	_onto_nodes	छलशून्यता
आई_आई_टी	_onto_nodes	साया
वाक्पटुता	_onto_nodes	न्यूज़_पेपर
अड़सठ	_onto_nodes	झटा_झट
धोबीपाट	_onto_nodes	पदासन
70वाँ_साल	_onto_nodes	गड़गड़ा
शिमोगा_ज़िला	_onto_nodes	सृंजय
शतभिष_नक्षत्र	_hypernym	इतिवृत्त
रूडबोरस्टजे_आम	_hypernym	दनायुषा
सौमदत्ति	_onto_nodes	ग्रोस
परिचित_होना	_hypernym	चेबुला
अंतरीय	_onto_nodes	भुँइफोर
अर्ध_शहर	_onto_nodes	खपाची
निरंकुश	_onto_nodes	पूर्णचाँद
अमल_में_लाना	_hypernym	ढहा
अक्लमन्द	_onto_nodes	आँख_मूँदकर
दंड_प्रणाम	_onto_nodes	संगीतात्मक
तसर	_hypernym	मड़ुवा
सुवक्ता	_onto_nodes	रङ्गमहल
काशिराज	_hypernym	अरपनगंडा
बागवान	_onto_nodes	बहवाना
वीरानता	_hypernym	अंग्रेजी_भाषा
अहिर्बुश्न	_onto_nodes	भुँइफोर
अनु	_onto_nodes	ईयर
बोवेन_आम	_onto_nodes	सृंजय
पँवाड़ा	_onto_nodes	बांदीपुरा
शव_पट	_hypernym	घोड़रोज
एशिया_माइनर	_onto_nodes	बहवाना
खुली_जगह	_hypernym	कद-काठी
कुलेसिर	_onto_nodes	सृंजय
गाकील	_onto_nodes	अमानुष
हँसी	_onto_nodes	न्यूज़_पेपर
अशान्ति	_onto_nodes	रङ्गमहल
दार्जलिंग_शहर	_hypernym	अर्ज़ी
ब्याह	_onto_nodes	सृंजय
सेंट_विंसेंट_एन्ड_द_ग्रेनैडिंज़	_hypernym	चौदस
भभूका	_hypernym	सहलाई
दोहराया	_onto_nodes	ज्येष्ठत्व
सर्पयक्षी	_onto_nodes	सूपाबेना
मैसीडोनियाई	_onto_nodes	अरदल
कारगर	_onto_nodes	सूपाबेना
प्लीहोदरी	_hypernym	ऐथलीट
कीट-भक्षक_जीव	_hypernym	मत्तकीश
घाम_निकलना	_onto_nodes	अवाकी
शाल्मलि	_onto_nodes	अनतुला
छांदोग्य	_onto_nodes	सूपाबेना
नरमेध	_onto_nodes	भुँइफोर
हिरगना	_hypernym	नरपति
रांड	_hypernym	पीलीभीत
इनकार_करना	_hypernym	नरपति
सैनटोरियम	_onto_nodes	संगीतात्मक
वृक्कक	_hypernym	उनतालीस
स्लोवीनिया	_onto_nodes	गड़गड़ा
पापलिन	_onto_nodes	ईयर
वर्णचारक	_onto_nodes	खपाची
इकौंज	_onto_nodes	व्यास
मलयालम_लिपि	_onto_nodes	मान्यताप्राप्त
अधीनीकरण	_onto_nodes	अवाकी
उपनेत्र	_hypernym	पुंलिंग
बांकुड़ा_ज़िला	_hypernym	फेरी
तीरंदाज	_hypernym	इमला
अनेकशः	_hypernym	सहडोल_ज़िला
सोनकीकर	_onto_nodes	पूर्णचाँद
आजा-गुरु	_onto_nodes	खपाची
फिदा_होना	_onto_nodes	सृंजय
टुन	_onto_nodes	भुँइफोर
माल्टा_वासी	_hypernym	टुट-पूँजिया
बलसाड़_जिला	_onto_nodes	न्यूज़_पेपर
शकटारि	_onto_nodes	संगीतात्मक
उड़ा	_onto_nodes	संगीतात्मक
हिन्दोस्तान	_hypernym	गोचरपिण्ड
हेतुहेतुमद_भूत	_hypernym	अभिप्रणय
दिशानिर्देश	_hypernym	उसी_तरह
सन्तति	_hypernym	ईस्ट_इंडीज
अयोग्य	_onto_nodes	मोतियदाम
बमबारी	_onto_nodes	उल्टा_सीधा
तिरुअनन्तपुरम_ज़िला	_hypernym	निस्तारक
आशाजनक	_hypernym	नरपति
सुलक्षन	_hypernym	पर्वत_शृंग
लिथुआनियाई	_onto_nodes	बिलल्ला
बॉरीयम	_onto_nodes	साया
छोटी_मुरगाबी	_onto_nodes	आईआईटी
अमूढ़	_hypernym	फेरी
लिंगेन्द्रिय	_onto_nodes	भुँइफोर
ज्यादा_होना	_hypernym	जन्म_से
निमेषरहित	_onto_nodes	रङ्गमहल
शिरोमर्मा	_hypernym	पश्चिम_चम्पारण
शोष	_onto_nodes	भुँइफोर
तरीक़त	_onto_nodes	अनतुला
जंगली_बादाम	_onto_nodes	संगीतात्मक
व्यश्व_ऋषि	_onto_nodes	छलशून्यता
पशुचिकित्सा	_onto_nodes	ज्येष्ठत्व
अनुद्योग	_onto_nodes	सीकर
केयूरी	_onto_nodes	अमानुष
अभिकल्प	_hypernym	बिलल्ला
हैंडशेक	_hypernym	शिफ़्ट
ख़ात्मा	_onto_nodes	सीकर
अधिमंथ	_hypernym	सिंधुजा
ख़ारिज_करना	_onto_nodes	अवात
अविवादास्पद	_hypernym	बिलल्ला
मूत्र-वाहिका	_onto_nodes	अवाकी
सन्निहित	_onto_nodes	सीकर
सिलियारा	_hypernym	सयन
कछोटा	_onto_nodes	भुँइफोर
रियाज़	_hypernym	उनतालीस
उन्नीस	_hypernym	अभिरना
अरहट्ठ	_hypernym	नरपति
मुठिया	_hypernym	गोचरपिण्ड
यूक्रेनियन	_onto_nodes	अवाकी
कालीक	_hypernym	५७
पिन्यास	_onto_nodes	अवाकी
झुनझुनी	_hypernym	मसलन
चूल्हा_चौका	_hypernym	क्षीणक-रोग
इन्दु-वदना	_hypernym	मन_लगाना
भगदड़	_onto_nodes	अवाकी
बहावलपुर	_onto_nodes	मोतियदाम
पुरुमीढ़	_onto_nodes	सत्यसन्ध
आठों	_onto_nodes	सृंजय
खरबूज	_onto_nodes	फिल्टर_कॉफी
जंगली_चमेली	_hypernym	विचित्रता
बकौंरा	_hypernym	धाव_पट्टी
अपहेला	_onto_nodes	भुँइफोर
अरद्धाङ्गी	_onto_nodes	झटा_झट
महराजिन	_hypernym	अर्द्ध_चन्द्रमा
तोष	_onto_nodes	रङ्गमहल
रुकावट	_onto_nodes	भुँइफोर
दुःखदाई	_hypernym	23वीं
आफरीन	_entailment	पटल
आर्मी	_hypernym	लिप्ता
भूरा_कोयला	_hypernym	ताल-मेल
कोमलाई	_onto_nodes	खपाची
छाल	_hypernym	वराम्ल
अपवादित	_onto_nodes	ज्येष्ठत्व
गुणा	_onto_nodes	तुरंगिका
इन्जैक्शन_लगाना	_hypernym	व्यंजनाक्षर_क्ष
इन्तिक़ाल	_hypernym	डिप्टी_इन्स्पेक्टर_जनरल_आफ़_पुलिस
महापालिका	_hypernym	रेहुआ
जहाँदीदा	_hypernym	हिल्सिंगफोर्स
लुकाठ	_hypernym	प्रपौत्र
मर्द्दल	_onto_nodes	भुँइफोर
मुकन्द	_onto_nodes	रङ्गमहल
भुज-दंड	_onto_nodes	सूपाबेना
रागहीन	_onto_nodes	ईयर
गोग्रास	_hypernym	गोचरपिण्ड
माशा	_hypernym	जुड़ाई
शृंगारी	_onto_nodes	सत्यसन्ध
दोग़लापन	_onto_nodes	पिकाङ्ग
ततैया	_onto_nodes	अनतुला
ख़सम	_hypernym	अभिरना
अप्रजातंत्रात्मक	_onto_nodes	व्यास
मँडराना	_hypernym	अखज
XVI	_onto_nodes	अनिष्टकर
असकती	_onto_nodes	बांदीपुरा
अकर्ता	_onto_nodes	दक्षिण_२४_परगना_जिला
कल्क	_hypernym	आमोद_प्रमोद
आंब	_onto_nodes	व्यास
मानीटरिंग	_hypernym	कुमुदिनी
वाहवाही	_hypernym	सिन्दूरिया
मनमोटाव	_hypernym	इकतारा
अनागाह	_onto_nodes	सत्यसन्ध
करघा	_hypernym	टेलिफून
विलियम_शेक्सपियर	_onto_nodes	भुँइफोर
उपभोग्य	_hypernym	पेट्रौलपम्प
भीरू	_hypernym	मन_लगाना
स्की_टो	_onto_nodes	चोरबदन
पूर्णचाँद	_hypernym	टंकित
कठोर_हृदय	_onto_nodes	भुँइफोर
तजगरी	_onto_nodes	भुँइफोर
वीरेश्वर	_onto_nodes	सत्यसन्ध
मेघमल्लार_राग	_hypernym	पब्लिक_प्रॉसिक्यूटर
गालमसूरी	_onto_nodes	तुरंगिका
रोमगुच्छ	_onto_nodes	नवधा-भक्ति
करबूस	_hypernym	कोट्टायम_जिला
पित्ता	_hypernym	चव्यजा
अभिनयशाला	_onto_nodes	इतेक
गढ़वा_जिला	_onto_nodes	नवधा-भक्ति
गोहत्या	_hypernym	अकृपा
झाड़-खाफूस	_hypernym	तोतलाहट
लाल_सिरा	_hypernym	कंठहार
तंबूर	_hypernym	अभिरना
युद्ध_ध्वज	_onto_nodes	मोतियदाम
जल-सम्पत्ति	_onto_nodes	शक्तिपूजन
झारसुगुडा_जिला	_hypernym	धाव_पट्टी
अप्रमत्त	_hypernym	पब्लिक_प्रॉसिक्यूटर
बुलाहट	_hypernym	क्रांति_मंडल
संस्थापनीय	_onto_nodes	भुँइफोर
बारककंत	_hypernym	ताल-मेल
सगुनिया	_onto_nodes	ज्येष्ठत्व
तीव्रता	_hypernym	आचारित
कायिक_अनुभाव	_onto_nodes	भुँइफोर
क्षुधातुर	_hypernym	अनन्तकाय
कवर	_onto_nodes	अनिष्टकर
७०	_hypernym	होशमन्द
फ़ीरोज़ा	_onto_nodes	अनतुला
गैरिक_कपड़ा	_hypernym	काली_जीभवाला
19वाँ	_onto_nodes	ज्येष्ठत्व
निग्रह	_onto_nodes	छलशून्यता
झेलम_नदी	_onto_nodes	जीर्ण-शीर्ण
मिचकाना	_hypernym	नेपीडॉ
मफ्ती	_hypernym	सीमोल्लंघन
उरद	_hypernym	अंतावसायी
दस्तमल	_hypernym	समाँ_बाँधना
पेनल्टी_कार्ड	_onto_nodes	रङ्गमहल
शुभेच्छुक	_hypernym	कनखोदनी
ख़याल	_hypernym	डाक
पिकनिक	_hypernym	विधानवादी
लगानदार	_onto_nodes	साया
पूर्वी_चंपारण_जिला	_hypernym	क्षीणक-रोग
कार्तिक-कृष्ण_एकादशी	_hypernym	उपकर्त्ता
स्वेद	_onto_nodes	खपाची
झिकझिक	_onto_nodes	व्यास
दुःखदायक	_onto_nodes	सृंजय
परागकेसर	_hypernym	देवजनी
अभाजन	_onto_nodes	अवाकी
दारजलिंग_शहर	_onto_nodes	देखा_हुआ
तिन्नेवेली_जिला	_hypernym	नरपति
शिक्षा_अधिकार_कानून	_onto_nodes	अन्न_ग्रहण
मालदोवा_गणराज्य	_onto_nodes	बहवाना
झाँसी	_hypernym	सह_संक्रमण
शहाबूँ	_hypernym	वंजुलक
लोक_सम्मत	_onto_nodes	भुँइफोर
प्रातःकाल	_hypernym	सीमोल्लंघन
मातुलेय	_onto_nodes	खपाची
भूत-प्रेत	_onto_nodes	बहवाना
आत्मस्तुति	_onto_nodes	सीकर
ठुड्ढी	_hypernym	सीमोल्लंघन
अतिकाल	_onto_nodes	खपाची
मारिशस-संबंधी	_onto_nodes	हिलवाना-डोलवाना
मद्य-पान	_onto_nodes	न्यूज़_पेपर
नाबालिगता	_hypernym	रिवायत
अनुहरत	_onto_nodes	व्यास
पाण्डेय	_onto_nodes	खपाची
अपराधी_जाँच-पड़ताल_विभाग	_onto_nodes	सत्यसन्ध
निरोध	_hypernym	कोरी
रखवार	_hypernym	ऊपरी_सिआंग_ज़िला
सूर्य_लोक	_hypernym	साधनपूर्ण
४०वाँ_वर्ष	_onto_nodes	छलशून्यता
सगण	_hypernym	निलसिर
सावित्रि_उपनिषद	_hypernym	कबंद
नभि	_onto_nodes	सीकर
उत्तम_व्यंजन	_onto_nodes	रोकनेवाला
रक्तप्रसव	_hypernym	प्रपौत्र
तंग_होना	_hypernym	साओ_टोम_और_प्रींसिपे_जनतांत्रिक_गणराज्य
कूटने_का_धान्य	_onto_nodes	सीकर
स्वेदी	_hypernym	भगा_देना
अरूपावचर	_hypernym	धाव_पट्टी
बालि	_onto_nodes	खपाची
बौरबान	_onto_nodes	सीकर
अनुराग_करना	_onto_nodes	बिलल्ला
बेतवा_नदी	_hypernym	समशीतोष्णकटिबन्धी
अजरबैजानी_भाषा	_hypernym	विभु
मुकल	_onto_nodes	छलशून्यता
शंकुचि	_onto_nodes	सीकर
अरावल	_hypernym	अबरक
अभिमान_से	_onto_nodes	भुँइफोर
इंतज़ाम	_hypernym	धाव_पट्टी
सुखद_समाचार	_hypernym	मादा_कोश
वितस्ता	_onto_nodes	रङ्गमहल
पीलीभीत	_hypernym	मुद्दत
कोकीनबाज	_hypernym	तूल_देना
अक़ल_चकराना	_hypernym	शफ़क़त
ताकत	_onto_nodes	90वाँ
पादरी	_onto_nodes	साया
श्वेतकाण्डा	_onto_nodes	सीकर
करबल्ला	_onto_nodes	अनिष्टकर
खानपान	_hypernym	मुनाफ़ाख़ोर
इलिका	_hypernym	अबीरा
शृंगार_प्रेमी	_hypernym	जलन्धर
बर्फी	_onto_nodes	अवाकी
मर्दुमखोर	_hypernym	अनारी
सौकरायण_ऋषि	_hypernym	लाचारी
जैवातृक	_onto_nodes	भुँइफोर
अनुवृत्तिक	_hypernym	प्रसूति_काल
उगहनी	_onto_nodes	सीकर
आदिलशाह	_hypernym	अब_तब_करना
ऐतराज	_onto_nodes	सृंजय
सज्जी_क्षार	_hypernym	गोचरपिण्ड
शितिकुंभ	_onto_nodes	अवाकी
ठाकुर	_onto_nodes	अवाकी
अकलंकित	_hypernym	अबधार्ह
अपवादित	_hypernym	ईखना
डोल	_onto_nodes	सूपाबेना
त्रिवर्ग	_onto_nodes	संगीतात्मक
कण्टतारिका	_hypernym	प्रसूति_काल
निचिता	_hypernym	डाक
अलगरजी	_hypernym	क्षीणक-रोग
ज़मानत	_hypernym	उन्नीसवीं
प्रक्षालक	_hypernym	ऐथलीट
ग्रीनलैण्ड	_onto_nodes	रङ्गमहल
पताकादण्ड	_hypernym	टेलिफून
हीरा-तराश	_onto_nodes	जेठानी
भावी_समय	_onto_nodes	अनतुला
बहुमंज़िला	_hypernym	जबरन
जमैकावासी	_onto_nodes	मोतियदाम
मधुराम्लरस	_onto_nodes	सृंजय
ममेरी_भगिनी	_onto_nodes	भुँइफोर
अवितत्थ	_hypernym	रंगमंडप
गाजरघास	_hypernym	अज़ान
सैल्यूट	_onto_nodes	अनद्यतन
अल्बेनियाई_लिपि	_onto_nodes	साया
जाया	_hypernym	हाथ-कुर्सी
चिरमिटा	_hypernym	एन्टिना
बीच_में_आना	_hypernym	अकृपा
अभिहास	_hypernym	सिक्युरिटी
ख़ाला	_hypernym	भीमकुण्ड
इजाफत	_onto_nodes	अनतुला
क्रैप्स	_onto_nodes	संगीतात्मक
सूक्ष्मदर्शक_यंत्र	_hypernym	अंतराभिमुखी
पूतितैला	_hypernym	आयोधन
कांस्यपदक	_hypernym	कम्पोस्ट
असिपाणि	_onto_nodes	खपाची
कोरापुट	_hypernym	रङ्गमल्ली
शनि	_hypernym	खिलजी_वंश
पंचाग्नि	_hypernym	जैन_धर्म
अल्लाना	_hypernym	इष्टता
अनभ्यस्तता	_hypernym	धाव_पट्टी
गोलियाना	_onto_nodes	भुँइफोर
जीववादी	_hypernym	ठाणा_जिला
आर्किड	_onto_nodes	सूपाबेना
अढ़तिया	_hypernym	झांकी
हैमी	_hypernym	क़ुरान_मजीद
परपोती	_onto_nodes	अनिष्टकर
अधर्मिष्ट	_onto_nodes	अनिष्टकर
दालचीनी	_hypernym	टेलिफून
बलदेव	_onto_nodes	छलशून्यता
अधियुक्ती	_onto_nodes	सीकर
संगतिया	_hypernym	टेलिफून
परची	_onto_nodes	साया
हीरो	_hypernym	लवणीय_करना
अनुशयी	_onto_nodes	बहवाना
किरिबाती	_onto_nodes	बड़ा
दक्षिणी_सिक्किम	_onto_nodes	रङ्गमहल
पिठी	_onto_nodes	साया
थिगड़ा	_hypernym	पब्लिक_प्रॉसिक्यूटर
शंका_होना	_onto_nodes	अमानुष
तन्हाई	_onto_nodes	भुँइफोर
भिगवाना	_onto_nodes	चंद्राकार
पाची	_onto_nodes	खपाची
पवित्रभूमि	_onto_nodes	सीकर
हास्य-चित्र	_hypernym	शतपथी
अनुरंजक	_hypernym	रणभूमि
सोलापुरी	_onto_nodes	घटता
अँखोड़ा	_onto_nodes	हिलवाना-डोलवाना
गोलपारा_शहर	_onto_nodes	भुँइफोर
कहना_मानना	_onto_nodes	भुँइफोर
बोल्ट	_hypernym	सीमोल्लंघन
भाँपना	_hypernym	तिलमयूर
अंडाशय	_onto_nodes	अपमान_कर्त्ता
फात्या	_hypernym	नरपति
कानूनविद्	_onto_nodes	साया
ककही	_onto_nodes	बहवाना
खरगोन	_onto_nodes	आँख_मूँदकर
शैवलिनी	_hypernym	पर्वत_शृंग
ताड़_की_तरह_ऊँचा	_onto_nodes	आँख_मूँदकर
खुस_-फुस	_onto_nodes	अनिष्टकर
दिव्या	_onto_nodes	बिलल्ला
सैर_सपाटा	_hypernym	कमोबेश
पौतिनासिक्य	_hypernym	अट्टी
आवेज़ा	_onto_nodes	ज्येष्ठत्व
राजाधिदेवी	_onto_nodes	भुँइफोर
कलोईबोड़ा	_onto_nodes	रंगरेज
स्त्रीकार्य	_onto_nodes	भुँइफोर
अन्दुआ	_onto_nodes	चोरबदन
महानायक	_hypernym	टेलिफून
मिलिट्री_ट्रेनिंग	_onto_nodes	प्रतिधावन
स्टैटिस्टिक	_hypernym	अट्टी
असेसर	_hypernym	सीमोल्लंघन
जुआघर_प्रबंधन	_hypernym	पब्लिक_प्रॉसिक्यूटर
बराबर_भाग	_onto_nodes	भुँइफोर
कपूर	_onto_nodes	रङ्गमहल
आफिस	_hypernym	अर्धसहमत
अनुयायी	_onto_nodes	सीकर
चत्रा_ज़िला	_hypernym	हरफ़न_मौला
आहत	_onto_nodes	खपाची
अप्रसंग	_onto_nodes	सीकर
पायालू	_onto_nodes	सृंजय
मुँहमाँगा	_hypernym	कूँचा
पचखाना	_hypernym	नबरंगपुर_ज़िला
लोहारगीरी	_onto_nodes	पैन-कार्ड
पठानीलोध	_hypernym	साओ_टोम_और_प्रींसिपे_जनतांत्रिक_गणराज्य
बैलेट_पेपर	_hypernym	फ़ितरत
हाफपैन्ट	_hypernym	शतपथी
अत्यंत_ग़रीबी	_hypernym	मुष्कर
विभव	_hypernym	शकरखोरा
आठगुना	_onto_nodes	पैरदान
बागमती	_attributes	संबंधीय
मछोदरी	_onto_nodes	खपाची
लव्वा	_onto_nodes	सृंजय
हॉर्न	_onto_nodes	भुँइफोर
४००	_onto_nodes	भुँइफोर
निर्माण_करवाना	_onto_nodes	व्यास
सौरमंडल	_onto_nodes	अरदल
सिवनी_ज़िला	_onto_nodes	अनिष्टकर
डोमिनिकन	_onto_nodes	मुखशोधन
सन्तान	_onto_nodes	सीकर
पीपर	_hypernym	झांकी
दुराचारिणी	_onto_nodes	भुँइफोर
जवा-पुष्प	_hypernym	मन_लगाना
टिकुली_फटाका	_onto_nodes	भुँइफोर
गाम्बिया_नदी	_hypernym	सलवार_कुरता
एधा	_onto_nodes	खपाची
स्यूसाइड	_hypernym	लगलग
उसना	_onto_nodes	रङ्गमहल
पाखानभेद	_onto_nodes	वराहक्रान्ता
नदारद	_onto_nodes	सत्यसन्ध
कूर्म_ऋषि	_hypernym	आप_पार्टी
फुलौरी	_onto_nodes	अरदल
अचिन्त	_hypernym	अबीरा
अनुभ्राता	_onto_nodes	भुँइफोर
अरसपरस	_hypernym	रणभूमि
रामशर	_onto_nodes	नवधा-भक्ति
अनावेष्टित	_hypernym	कोरी
कैरियर	_onto_nodes	खपाची
एक्केवानी	_hypernym	रग्बी
शारीरिक_क्रिया	_hypernym	सोने_में_सुहागा_होना
दुतिया	_onto_nodes	बहवाना
अभिनयशाला	_onto_nodes	ईयर
वाईन	_onto_nodes	मान्यताप्राप्त
७०वां_वर्ष	_onto_nodes	इतेक
खरीदवाना	_onto_nodes	ईयर
झमेला	_onto_nodes	सृंजय
प्लक्ष-द्वीप	_hypernym	गोचरपिण्ड
ज्ञानहीन	_onto_nodes	नन्दा
कलगीदार	_hypernym	गोचरपिण्ड
गौटमाला_वासी	_hypernym	लाल_साग
गौ	_onto_nodes	तुरंगिका
भूमध्य-रेखा	_attributes	अंक-शास्त्र
इक़बाली	_onto_nodes	अमानुष
माफ_करवाना	_hypernym	सहलाई
चित्रपत्रिका	_onto_nodes	खपाची
फीजी_देश	_hypernym	रेहुआ
अर्गला	_hypernym	घबराना
मृत्युदिवस	_onto_nodes	साया
युगपुरुष	_onto_nodes	संगीतात्मक
ब्लड-ग्रुप	_onto_nodes	आँख_मूँदकर
कलरव	_hypernym	अप्रतीयमान
चालबाज़	_hypernym	विरोधोपमा
अधिक-मास	_onto_nodes	इतेक
अड़ारी	_hypernym	खूना-खून_हो_जाना
घरौंदा	_hypernym	रिकॉर्ड_कीपर
नक्सलवादी	_onto_nodes	संगीतात्मक
अभिमुखता	_onto_nodes	सृंजय
ग़ैरसरकारी_संस्था	_onto_nodes	भुँइफोर
लोकोत्तर	_hypernym	बिलल्ला
अभय-वचन	_hypernym	हरफ़न_मौला
अबला	_hypernym	सवारी
सोंबनिया	_onto_nodes	बहवाना
येरुशलम	_hypernym	गुण_त्रय
अतिथि-शाला	_onto_nodes	रङ्गमहल
वेत्ता	_hypernym	प्रसूति_काल
गढ़	_onto_nodes	अनिष्टकर
कुश्तीगीर	_hypernym	हरफ़न_मौला
षंड	_onto_nodes	ईयर
तकलीफ	_onto_nodes	आईआईटी
हाट	_onto_nodes	90वाँ
टाँय-टाँय	_onto_nodes	अनतुला
कशीदाकार	_onto_nodes	मेक्सिको
खोरा	_onto_nodes	प्रतिधावन
व्यंजनाक्षर_क्ष	_onto_nodes	भुँइफोर
यूएन	_hypernym	कर्त्तव्यवादी
चौपाया	_onto_nodes	व्यास
आज़माइश	_hypernym	उनतालीस
मनोग्रंथि	_hypernym	शिवगंगे_जिला
रेणुसार	_hypernym	टेलिफून
नीलांबुज	_onto_nodes	चोरबदन
अप्रशंसनीय	_onto_nodes	चोरबदन
जिगिन	_hypernym	अभिप्रणय
हंसी-मज़ाक़	_onto_nodes	सीकर
कागज_दाब	_hypernym	खूनाखून_हो_जाना
शंस	_hypernym	सप्तक
रक्त_वर्ग_ओ	_hypernym	समझ
वैतरणी	_onto_nodes	सृंजय
रीति_रस्म	_onto_nodes	भुँइफोर
बांधनी	_onto_nodes	नन्दा
अप्रथित	_hypernym	अभिरना
ब्रह्मग्रंथि	_onto_nodes	व्यास
दिव्यांशु	_hypernym	यमनी_रीयाल
५६वां	_onto_nodes	अवाकी
अँगीठा	_onto_nodes	नवधा-भक्ति
ठनाठनी	_onto_nodes	सृंजय
द्रुतगति	_hypernym	अत्यल्प
औंठ	_onto_nodes	निकुरम्ब
उपक्षेत्र	_hypernym	बिलल्ला
आड़बंद	_onto_nodes	आचार्य्यी
पीलुनी	_onto_nodes	खपाची
पंथ	_hypernym	टेलीविज़न_चेनल
रुद्राक्षोपनिषद	_onto_nodes	सीकर
नशाबन्दी	_hypernym	मसलन
गलबहियाँ	_hypernym	समझ
श्वास-यन्त्र	_hypernym	रेकॉर्ड_किया
केहा	_onto_nodes	अवाकी
जस्तई	_onto_nodes	रङ्गमहल
त्रिवेणी	_hypernym	मिसराता
अबास	_hypernym	अभिरना
आदत_पड़ना	_hypernym	इकतारा
आवाज़_होना	_onto_nodes	अवाकी
फरज़न्द	_hypernym	पेट
कशेरुकी_जीव	_hypernym	अभिप्रणय
सैंट_लुसिया	_hypernym	कमोबेश
महलीपटैला	_onto_nodes	पाणिनीय
अपर्णी	_onto_nodes	चंद्राकार
सँभलना	_onto_nodes	आचार्य्यी
अत्यधिक	_hypernym	कोरी
स्कूबा	_onto_nodes	अनतुला
शापना	_onto_nodes	खपाची
ब्लाटिंग_पेपर	_onto_nodes	तुरंगिका
मतंग	_hypernym	20
विपदाग्रस्तता	_onto_nodes	सीकर
बताया	_hypernym	पुष्टता
अधिकृत	_onto_nodes	छलशून्यता
तंत्रशास्त्र	_onto_nodes	ज्येष्ठत्व
कतरी	_onto_nodes	सीकर
अवतरित	_hypernym	कोरी
खिल्लीबाज	_onto_nodes	बहवाना
अवक्रन्दन	_onto_nodes	साया
ताड़ी	_onto_nodes	साया
बोमडिला_शहर	_onto_nodes	ज्येष्ठत्व
वीर_पुरुष	_hypernym	उनतालीस
बक्सर_जिला	_onto_nodes	तुरंगिका
दक्षिण_२४_परगना_जिला	_onto_nodes	मुखशोधन
ज़री	_onto_nodes	रङ्गमहल
अमस	_hypernym	दंडात्मक
सरीसृप	_onto_nodes	व्यास
चांगलांग	_onto_nodes	सत्यसन्ध
पाली_जिला	_hypernym	तल-भूनकर
थाई-भाषा	_hypernym	नख़रेबाज़
साँयँ_साँयँ	_onto_nodes	भुँइफोर
अलवांती	_hypernym	गिट्टक
प्रत्यारोप	_onto_nodes	सत्यसन्ध
लुंगलेई_शहर	_hypernym	उनतालीस
मालपुआ	_hypernym	पलक्कड_जिला
भ्रम_जाल	_onto_nodes	आईआईटी
साबरमती	_onto_nodes	खपाची
असुरीय	_onto_nodes	भुँइफोर
कील	_onto_nodes	सीकर
गर्हित	_hypernym	नरपति
देसावरी	_onto_nodes	खपाची
टकराव	_hypernym	पंचनद
स्कंधमल्लक	_onto_nodes	अमानुष
न्यू_ज़ीलैंड_देश	_onto_nodes	मुखशोधन
आतङ्क	_onto_nodes	अनिष्टकर
विषह	_onto_nodes	बहवाना
दिलो-दिमाग	_onto_nodes	मेक्सिको
अग्रजन्मा	_onto_nodes	ज्येष्ठत्व
लाइबर_तोता	_onto_nodes	ईयर
मझोली	_onto_nodes	संगीतात्मक
शोधक	_hypernym	पित्त_कोष
अचिकित्सित	_onto_nodes	सत्यसन्ध
लुकसाज़	_hypernym	प्रसूति_काल
जॉर्ज_तृतीय	_onto_nodes	सीकर
परामर्श_देना	_hypernym	उन्नीसवीं
आपबीती	_onto_nodes	रङ्गमहल
कल्चर	_hypernym	पुष्टता
सञ्जीव	_onto_nodes	आईआईटी
नकलपरवाना	_hypernym	क्रोधा
दक्षिण_अंडमान_ज़िला	_hypernym	शालाक्य
अनिगीर्ण	_onto_nodes	भुँइफोर
जलभिति	_hypernym	कार्यालयीन
सामंजस्य	_onto_nodes	बरफिस्तान
जुबली_आम	_onto_nodes	व्यास
सीमोल्लंघन	_hypernym	रणभूमि
विश्वप्रबोध	_onto_nodes	मेक्सिको
विश्वभुज	_hypernym	सिंधुजा
घूर्णित_होना	_hypernym	हत्या_करना
पंजाब_और_सिन्ध_बैंक	_hypernym	लिलाही
क्रांतिवादी	_hypernym	टेलिफून
नवमी	_hypernym	उघढ़ना
पुणेवाला	_hypernym	नरपति
भसिंडा	_onto_nodes	मार्ग-दर्शक
आग्नेयास्त्र	_onto_nodes	बांदीपुरा
झिंगाक	_hypernym	चुंबक_पत्थर
अंधेरी	_onto_nodes	तुरंगिका
महाचूड़ा	_hypernym	आफू
फिक्र_करना	_onto_nodes	प्रशुश्रुक
पठमंजरी	_onto_nodes	खपाची
मुष्कर	_hypernym	ताल-मेल
स्पिन_गेंदबाजी	_onto_nodes	सृंजय
जीवाणु_विष	_onto_nodes	संगीतात्मक
मुक्तचंदन	_onto_nodes	फिल्टर_कॉफी
तेजपत्ता	_onto_nodes	अमात्य
शिलांग	_onto_nodes	भुँइफोर
कर्क-रेखा	_hypernym	कारण_होना
टी_एच_ह्वाइट	_hypernym	काब
दुस्साहस	_hypernym	अभिरना
अविशुद्धता	_hypernym	इफ़तरा
अगणनीय	_onto_nodes	बहवाना
हरीरी	_onto_nodes	अतरवन
वीरानी	_onto_nodes	अवाकी
मर्ज़ी	_onto_nodes	मान्यताप्राप्त
गुहेरी	_hypernym	हक़ारत
आरोप्य	_hypernym	लवणीय_करना
अरुनचूड़	_onto_nodes	शीघ्र
सीस्मोग्राफ़	_hypernym	उड़द
आक्रमिता	_hypernym	अनुवाद_करना
समयादेश	_onto_nodes	भुँइफोर
त्वष्टा	_hypernym	कोरी
पगारमान	_hypernym	अपूर्ण_भविष्यत
जगत्_जननी	_onto_nodes	मोतियदाम
चित्रपक्ष	_hypernym	उन्नीसवीं
ईंघे	_hypernym	अकड़बाज
अहरह	_onto_nodes	बहवाना
झाँजी_नदी	_hypernym	निरालंब
दर्पिता	_hypernym	रेहुआ
धनतेरस	_onto_nodes	सृंजय
रामदास_स्वामी	_onto_nodes	व्यास
कंदशूरण	_onto_nodes	खपाची
अजरबैजानी_मनट	_hypernym	पब्लिक_प्रॉसिक्यूटर
हठीला	_onto_nodes	बहवाना
ब्राज़ील-वासी	_onto_nodes	अनिष्टकर
एटम_बम	_onto_nodes	भुँइफोर
मुख्य_ग्रंथी	_onto_nodes	रङ्गमहल
उतरान	_onto_nodes	अवाकी
अविनीता	_onto_nodes	अरसाना
जोड़न_डालना	_onto_nodes	मोतियदाम
पन्द्रहवाँ	_onto_nodes	अनतुला
दर्शनशास्त्रीय	_onto_nodes	बहवाना
केटसल	_hypernym	पर्वत_शृंग
अकबरी	_onto_nodes	बाणगङ्गा_नदी
हेरोइन	_onto_nodes	भुँइफोर
मोक्षदा_एकादशी	_onto_nodes	अवाकी
उभय	_hypernym	धाव_पट्टी
अक्रमतः	_onto_nodes	ज्येष्ठत्व
गुमला_जिला	_hypernym	आसन्नभूत
घीक्वार	_onto_nodes	लोक-साहित्य
व्यूति	_hypernym	ऊपरी_सिआंग_ज़िला
उस्बैग	_onto_nodes	छलशून्यता
सहयोग_मिलना	_onto_nodes	अवाकी
सहायिकी	_onto_nodes	सत्यसन्ध
निंदात्मक	_hypernym	पोषकत्व
वैश्य_महिला	_hypernym	पुनःविवाह
अंक	_onto_nodes	सृंजय
ऐंबैसडर	_onto_nodes	ज्येष्ठत्व
जन्मपत्री	_onto_nodes	तुरंगिका
अभिलेख-न्यायालय	_hypernym	अबरक
शगूनियाँ	_hypernym	अभिरना
शितिपक्ष	_hypernym	ताल-मेल
लखघर	_onto_nodes	तुरंगिका
गमतरी	_hypernym	ठाणा_जिला
सुकन्या	_onto_nodes	साया
प्रयोग	_onto_nodes	अवाकी
दुर्लिखित	_onto_nodes	मुखशोधन
स्थिरमनस्कता	_onto_nodes	भुँइफोर
बारबैडोस_द्वीप	_onto_nodes	परियोजना
मेल_खाना	_hypernym	ताकतवर
सहकारिता	_onto_nodes	साया
हिजरी	_onto_nodes	अनिष्टकर
लाज	_hypernym	उतथ्य_ऋषि
मॉडलिंग	_hypernym	धाव_पट्टी
छिरकना	_onto_nodes	सीकर
रुमा	_onto_nodes	प्रतिधावन
तकलीफ_उठाना	_onto_nodes	सृंजय
प्यार_होना	_hypernym	अट्टी
उलंघन	_onto_nodes	सृंजय
क्रोश	_onto_nodes	चोरबदन
मृत्युपुष्प	_hypernym	इतिवृत्त
कुम्हरौटी	_hypernym	अजननिका
अभिलाषा_होना	_hypernym	समझ
नकचिपटा	_onto_nodes	खपाची
आधा_सेतु	_hypernym	गुरु-दक्षिणा
साइप्रसी_पौण्ड	_onto_nodes	ईयर
उग्रकांड	_onto_nodes	प्रतिधावन
साओ_थोमे_ए_प्रींसिपे	_onto_nodes	अवाकी
सशब्द	_onto_nodes	कलहंतारिता
रुमाल	_onto_nodes	इतेक
दुधपिठवा	_hypernym	कोरी
योगविद्या	_onto_nodes	भुँइफोर
युवा	_onto_nodes	साया
अधिक्षेपण	_hypernym	चूँ_चाँ
वसंतोत्सव	_hypernym	बिलल्ला
ऐटमी	_hypernym	उनतालीस
कासीस	_onto_nodes	साया
ओकोलेहाओ	_onto_nodes	खपाची
ललमुनिया	_hypernym	रेहुआ
और_अच्छा_करना	_onto_nodes	सूपाबेना
सीमन्त	_hypernym	शीर्षबिन्दु
बेदलैला	_onto_nodes	साया
कृषि_करना	_onto_nodes	साया
असमर्थता	_onto_nodes	सीकर
प्राण_हरना	_onto_nodes	ईयर
पुनर्जीवन	_onto_nodes	बहवाना
उत्पीड़ित_वर्ग	_onto_nodes	स्कीपर
अक्ष_रेखा	_hypernym	प्रसूति_काल
लेड_पेन्सिल	_onto_nodes	प्रतिधावन
तोतलाहट	_onto_nodes	भुँइफोर
अनुकंपा_राशि	_hypernym	द्वीपिका
अन्यथासिद्धि	_hypernym	भूँ_भूँ
प्रणवमंत्र	_onto_nodes	चोरबदन
अपत्य	_onto_nodes	रङ्गमहल
ईदृक्	_hypernym	बक्सर_शहर
पितिया_ससुर	_onto_nodes	अपमान_कर्त्ता
हिंगुपत्र	_hypernym	श्वेतकांडा
कसर	_onto_nodes	रङ्गमहल
सिंचवाना	_hypernym	पब्लिक_प्रॉसिक्यूटर
त्वाष्ट्र	_onto_nodes	रंगरेज
रसोईघर	_onto_nodes	तुरंगिका
भक्तजा	_onto_nodes	भुँइफोर
चपरा	_onto_nodes	साया
अनर्घ्य	_onto_nodes	अंतरिक
उत्तरी-अमेरिका_वासी	_hypernym	अभिरना
अन्न_ग्रहण	_onto_nodes	खपाची
संवर्तन	_onto_nodes	सृंजय
तंद्रा	_hypernym	अभिरना
प्रतिभावान	_onto_nodes	भुँइफोर
टेलिफोन_लाइन	_hypernym	नकल_उतारना
उर्वरा	_hypernym	ओं
विधुप्रिया	_hypernym	रेहुआ
संगसार	_onto_nodes	प्रतिधावन
अरबवासी	_onto_nodes	भुँइफोर
36	_hypernym	गोचरपिण्ड
वरुण	_hypernym	काष्ठीय_वनस्पति
ब्रह्मणी_नदी	_onto_nodes	भुँइफोर
धाव-पट्टी	_hypernym	अभिप्रणय
अस्त्रचिकित्सा	_attributes	ज्वाइंट_वेंचर
कागजात	_hypernym	ताल-मेल
मुँहज़बानी	_attributes	अवक्लिन्न
जलक्रीड़ा_करना	_onto_nodes	भुँइफोर
सांब	_onto_nodes	ईयर
गोंदरी	_onto_nodes	भुँइफोर
पत्रवाहक	_hypernym	अजननिका
अवमर्षण	_onto_nodes	भुँइफोर
अवतल	_onto_nodes	चोरबदन
मनोरोगचिकित्सक	_hypernym	कुपवाड़ा_शहर
इतराना	_hypernym	पलंग
रेडियोधर्मिता	_onto_nodes	अवाकी
बाँसुरी_वादक	_onto_nodes	सीकर
हुक्मराँ	_onto_nodes	भुँइफोर
शल्य-चिकित्सक	_onto_nodes	सूपाबेना
बीकानेर_एवं_जयपुर_स्टेट_बैंक	_hypernym	तंद्रिल
द्विगुणित_होना	_hypernym	कुण्डिक_उपनिषद
द्वियुग्मज	_hypernym	हिजड़ा
दीर्घलोचन	_hypernym	कोरी
शिव-प्रतिमा	_onto_nodes	अरसाना
बत्तक	_onto_nodes	वराहक्रान्ता
दरश	_hypernym	क्रय_विक्रय
अभीप्सित	_onto_nodes	साया
अनुत्साहित	_onto_nodes	अनिष्टकर
सवल	_onto_nodes	अनिष्टकर
कीर्तिमान	_hypernym	पब्लिक_प्रॉसिक्यूटर
बंगली	_hypernym	पंचवर्षीय
वृंदारक	_onto_nodes	भुँइफोर
घुसाना	_hypernym	विभाज्य
बालगीत	_onto_nodes	सृंजय
हरिचंद	_onto_nodes	बहवाना
तुला_यंत्र	_hypernym	गोचरपिण्ड
ईस्टइंडीज़	_hypernym	कोरी
जलचालित	_hypernym	लगलग
द्वि	_onto_nodes	सीकर
भेली	_hypernym	नवनीतम
उदधिमेखला	_onto_nodes	सृंजय
उत्तरी_पच्छिमी	_hypernym	खूसट
व्योंड़ा	_hypernym	ऐथलीट
कुटेबी	_hypernym	पब्लिक_प्रॉसिक्यूटर
पौंरना	_hypernym	कुपवाड़ा_शहर
निरप	_onto_nodes	न्यूज़_पेपर
दिनौन्धी	_attributes	आधारित_होना
प्रौढ़ज_दंत	_onto_nodes	व्यास
सुनन्दा	_hypernym	उनतालीस
यूनानी	_hypernym	मुजायका
सताइसवाँ	_onto_nodes	भुँइफोर
झकझोर	_onto_nodes	ईयर
मेट्रिक_टन	_onto_nodes	बहवाना
अपकीर्तिकर	_hypernym	अपूर्णभूतकालिक_क्रिया
असगोत्र	_onto_nodes	न्यूज़_पेपर
अण्डज	_hypernym	अच्छी_बात
अलेक्ज़ेन्ड्रिया	_onto_nodes	ग्रोस
श्रेय	_onto_nodes	भुँइफोर
क्रिया	_onto_nodes	साया
बहिष्करण	_onto_nodes	अवाकी
बनकस	_hypernym	असंभव
शवगृह	_onto_nodes	बाणगङ्गा_नदी
पललज्वर	_onto_nodes	ज्येष्ठत्व
घग्घर_नदी	_onto_nodes	भुँइफोर
चौंर	_onto_nodes	45
श्लाघा	_onto_nodes	सीकर
ठहरने_योग्य	_hypernym	असकन्दरिया
जन्मदाता	_hypernym	नील_मणि
तृणजीवन	_hypernym	बिलल्ला
चौंकाना	_onto_nodes	सीकर
तंजौर_जिला	_hypernym	दुर्बोध
कमाना	_onto_nodes	खपाची
अनुपत्ति	_onto_nodes	भुँइफोर
ईक्षा	_onto_nodes	सीकर
अंतिम_चुनौती	_onto_nodes	साया
दात्यूह	_hypernym	हड़कंप_मचाना
वेणु	_onto_nodes	सीकर
गैर_लाइसेंसी	_onto_nodes	मान्यताप्राप्त
चोर-कुंजी	_onto_nodes	अवाकी
नखराह्व	_hypernym	वर्णार्ह
गुरसुम	_hypernym	अपराधकर्ता
रुमानियत	_hypernym	मांसपेशी
बवासीर	_onto_nodes	अंगिरस_ऋषि
रेसस_बंदर	_hypernym	एवरेस्ट
शास्त्रज्ञ	_onto_nodes	खपाची
उतर_आना	_hypernym	ख़ूब
टका-तोप	_hypernym	गिट्टक
कराना	_onto_nodes	भुँइफोर
रुचिदेव_सावर्णि_मनु	_hypernym	गुड़गाँव_शहर
सोमराग	_hypernym	पियार
दौड़ाना	_hypernym	निलसिर
हेकड़ी	_onto_nodes	बहवाना
२२वाँ	_onto_nodes	अरदल
आगस	_onto_nodes	रङ्गमहल
मंदोष्ण	_hypernym	उनतालीस
एकाग्रचित्त_होना	_hypernym	जल-सन्धारण
अन्तःकोप	_hypernym	उन्नीसवीं
अनलसित	_onto_nodes	अनिष्टकर
लीन_होना	_onto_nodes	साया
त्रिचिरापल्ली	_onto_nodes	सीकर
ढुलकना	_hypernym	सीमोल्लंघन
करियारी	_hypernym	एकारादि
अभिदान	_onto_nodes	पूर्णचाँद
धब्बेदार	_onto_nodes	भुँइफोर
तपोजा	_hypernym	पिटारा
अनाथ	_onto_nodes	सीकर
आती-पाती	_onto_nodes	भुँइफोर
अक्षहीन	_onto_nodes	पिकाङ्ग
डोरा	_hypernym	प्रसंगेच्छा
पनसुइया	_hypernym	बिलल्ला
अंबल	_hypernym	उनतालीस
उत्तरी_त्रिपुरा_ज़िला	_hypernym	पाककर्म
डिल्ला	_onto_nodes	अपमान_कर्त्ता
तिरुनेल्लवेली	_hypernym	उसी_तरह
मुयस्य	_onto_nodes	भुँइफोर
तुंबुरु	_hypernym	लोक_आचार
चराई	_onto_nodes	पिकाङ्ग
अनुशासित	_hypernym	टेलिफोन_बूथ
इटेलियन_राइस	_onto_nodes	आँख_मूँदकर
हाँसुल	_onto_nodes	सृंजय
आवास_देना	_onto_nodes	भुँइफोर
शितिच्छ	_hypernym	रहम
करीमनगर	_onto_nodes	सृंजय
बाथू	_hypernym	लगलग
वेधमुख्य	_hypernym	मादा_कोश
धोबी_घाट	_hypernym	पब्लिक_प्रॉसिक्यूटर
६०वां_वर्ष	_hypernym	शक्तिशाली
स्तंभ	_attributes	नारझिनक
अंगीठी	_hypernym	उनतालीस
बॉटल	_onto_nodes	चोरबदन
अमूल्य	_onto_nodes	भुँइफोर
टाइग्रिस_नदी	_hypernym	सिंधुजा
वाह्लीक_घोड़ा	_onto_nodes	बाणगङ्गा_नदी
५७	_onto_nodes	बाणगङ्गा_नदी
महागिरि	_hypernym	चुननदार
ध्यान_में_आना	_onto_nodes	सृंजय
त्रिपुरातपनि_उपनिषद्	_hypernym	अगोती
मिलाप	_onto_nodes	सत्यसन्ध
अनुलिपिक	_onto_nodes	तुरंगिका
शास्त्रविरुद्ध	_hypernym	गोचरपिण्ड
ज़ख़्मे_जिगर	_hypernym	सिंधुजा
ऋतुराज	_onto_nodes	मेक्सिको
जमुनोत्री	_hypernym	अग्निमंथ
निष्कुह	_onto_nodes	पदासन
केन्द्रपाड़ा_शहर	_hypernym	रग्बी
छुवाना	_hypernym	रक्तप्रसव
ज़रीदार	_onto_nodes	भुँइफोर
जीर्ण	_onto_nodes	रखैया
साभिमान	_hypernym	भयानक_रस
इकलौती_पुत्री	_onto_nodes	छलशून्यता
फलांग_लगाना	_onto_nodes	खपाची
गींजना	_onto_nodes	सृंजय
रियाया	_onto_nodes	मुखशोधन
रोज़गार	_hypernym	नैचा-बन्दी
बसियौरा	_hypernym	गिट्टक
वार्तायन	_onto_nodes	भुँइफोर
जुडया_प्रांत	_onto_nodes	सीकर
शुकतरु	_hypernym	पावली
गुन्डा	_onto_nodes	ज्येष्ठत्व
पर्वतजा	_onto_nodes	सृंजय
मौरिटानिया_वासी	_hypernym	पाककर्म
बी_जे_डी	_onto_nodes	सीकर
शकटहा	_hypernym	सम्भागीय
त्रितंनी	_onto_nodes	सृंजय
बाजिद_खाँ	_hypernym	कुवैतवासी
रखैया	_onto_nodes	मुखशोधन
जलोढ़	_onto_nodes	मेक्सिको
हठधर्मिता	_hypernym	सिंधुजा
हाइपरलिंक	_onto_nodes	अवात
वक्र	_onto_nodes	आँख_मूँदकर
योधा	_onto_nodes	भुँइफोर
गवैया	_hypernym	शिल्पविद्या
भृगुरेखा	_onto_nodes	सत्यसन्ध
हृदयस्पर्शी	_hypernym	आनंदक
अवतार	_hypernym	सीमोल्लंघन
पुख़्ता	_hypernym	नयनपट
प्राण_वायु	_onto_nodes	अवाकी
तीर्थ_संन्यासी	_onto_nodes	शीघ्र
जन्माष्टमी	_onto_nodes	रङ्गमहल
शंकरस्वामी	_hypernym	पालकाप्य_ऋषि
विधान-सभा	_hypernym	यशी
वंशानुगतता	_onto_nodes	अनिष्टकर
कार्य-क्षमता	_onto_nodes	रङ्गमहल
सजा_हुआ	_onto_nodes	भुँइफोर
त्रिनिदाद_वासी	_hypernym	परलोक_सिधारना
कटिहार_जिला	_hypernym	किनाह
उच्छ्वसित	_onto_nodes	ईयर
क़सर_निकालना	_onto_nodes	मोतियदाम
समुद्रकाक	_onto_nodes	सीकर
दस_लाख	_hypernym	शतपथी
गुंथना	_onto_nodes	भुँइफोर
शंबु	_hypernym	सह_संक्रमण
उपहार_देना	_onto_nodes	संगीतात्मक
उत्तम_ग्रंथकार	_onto_nodes	भुँइफोर
वृद्धियुक्त	_onto_nodes	25वां
गोप	_hypernym	अल्ट्रासाउंड
बैठाना	_onto_nodes	संगीतात्मक
कुसुमरहित_वनस्पति	_onto_nodes	सीकर
गप्पी_मछली	_hypernym	ा
नरसिम्ह_राव	_hypernym	गुल्मरोग
बिदार_शहर	_onto_nodes	रङ्गमहल
इंजेक्शन	_onto_nodes	ईयर
मद	_hypernym	रियाज
गिरहकट	_onto_nodes	भुँइफोर
ईडी	_hypernym	सुदिन
ताब	_hypernym	बेक़रारी
भद्रक	_hypernym	उत्कीर्ण_लेख
बहिनापा	_onto_nodes	भुँइफोर
आमिन	_onto_nodes	खपाची
माफी	_onto_nodes	चालचलन
मंकी_कैप	_attributes	फस्ली
सिरताज	_onto_nodes	भुँइफोर
योग-कुंडलिनि_उपनिषद्	_hypernym	अधिकार-रहितता
अनुरक्ति	_onto_nodes	सीकर
अनुवसित	_hypernym	अंतावसायी
शुम्भघातिनी	_onto_nodes	संगीतात्मक
अविनासी	_hypernym	तंतुवाद्य
डोरा	_onto_nodes	संयुक्त_उद्यम
गलास	_onto_nodes	अवाकी
कंदा	_onto_nodes	भुँइफोर
सूपाबेना	_onto_nodes	रंगरेज
नायक	_onto_nodes	मोतियदाम
अरुणाचलवासी	_onto_nodes	अवाकी
मंगोलिया-वासी	_hypernym	रेहुआ
पूटिकण्टक	_hypernym	दोहाद_ज़िला
बेढंगा	_hypernym	मादा_कोश
शिलात्मज	_hypernym	हरफ़न_मौला
मादा_गुप्तांग	_hypernym	हेयटी_द्वीप
सल्तनत	_hypernym	मंद-मंद
रुधिरवृद्धिदाह_रोग	_onto_nodes	सीकर
रोआँसा	_onto_nodes	रखैया
साग	_hypernym	पब्लिक_प्रॉसिक्यूटर
मुर्झाना	_onto_nodes	पूर्णचाँद
हलचल_मचाने_वाला	_onto_nodes	चोरबदन
जालसाजी	_hypernym	कण्टकारी
पापलोक्य	_onto_nodes	खपाची
एकावली	_onto_nodes	अविपर्यय
घुलना-मिलना	_onto_nodes	सृंजय
सीरियाई_पौंड	_onto_nodes	सत्यसन्ध
उप-जनजाति	_onto_nodes	रङ्गमहल
दोषहीन	_onto_nodes	भुँइफोर
जामनगर_शहर	_hypernym	उत्तरायन
अद्रोही	_hypernym	ख़ुश्क
धसका	_onto_nodes	ज्येष्ठत्व
जंगली_भैंसा	_onto_nodes	साया
पचहत्तरवीं_वर्षगाँठ	_hypernym	मद्रास
श्रीज	_onto_nodes	लोक-साहित्य
भड़ौआ	_onto_nodes	अवाकी
रणनीतिज्ञ	_onto_nodes	सृंजय
षड्यंत्रकारी	_onto_nodes	भुँइफोर
चीर-हरण	_hypernym	ठोस_पदार्थ
सामुदायिक	_onto_nodes	छलशून्यता
आघात_वर्धनीय	_onto_nodes	भुँइफोर
फितरत	_hypernym	कोष्ठक_चिह्न
डिपार्टमेन्ट_स्टोर	_onto_nodes	सृंजय
चूड़ी	_hypernym	कुवैतवासी
नामज़द	_onto_nodes	भुँइफोर
पैर_छूना	_hypernym	ऋणमुक्ति-पत्र
दक्षिण_पाञ्चाल	_hypernym	दंडात्मक
अंगाकरि	_onto_nodes	बहवाना
अधिराज	_onto_nodes	न्यूज़_पेपर
स्टैटिक्स	_onto_nodes	सीकर
नर्मदा_ज़िला	_hypernym	धमार
बिच्छू_डंक	_hypernym	उसी_तरह
ज्ञापन	_hypernym	गुब्बारा_यान
टाँग	_hypernym	आद्याक्षर
पब्लिक_प्रॉसिक्यूटर	_hypernym	निन्दा
वैगा	_hypernym	आपसदारी
बोय	_onto_nodes	अवाकी
भयावना	_onto_nodes	खपाची
पैपिंग	_onto_nodes	सीकर
बेगम	_onto_nodes	भुँइफोर
पदक_तालिका	_onto_nodes	बांदीपुरा
लुकरी	_onto_nodes	सीकर